sondern	а
nämlich	а именно
das Abonnement, -s/-e	абонемент
die Aprikose, -n	абрикос
die Marille, -n (A) → D, CH: Aprikose	абрикос
absolut	абсолютный
der August, -(e)s и -, -e	август
Österreich der Österreicher, - die Österreicherin, -nen österreichisch	Австрия австриец
der Bus, -se	автобус
der Automat, -en	автомат
automatisch	автоматический
das Auto, -s	автомобиль
der Anrufbeantworter, -	автоответчик
der Autor, -en die Autorin, -nen	автор
der Anwalt, ¨-e die Anwältin, -nen	адвокат
die Behörde, -n	административное учреждение
ordentlich	аккуратный
der Schauspieler, - die Schauspielerin, -nen	актер
die Aktivität, -en	активность
aktiv	активный
aktuell	актуальный
die Aktion, -en	акция
das Alphabet, -e	алфавит
die Alternative, -n	альтернатива
alternativ	альтернативный
analysieren, analysiert, analysierte, hat analysiert	анализировать
die Annonce, -n	анонс
der Apparat, -e	аппарат
das Apartment, -s	аппартаменты
der Appetit, -(e)s, -e	аппетит
der April	апрель
die Apotheke, -n	аптека
die Drogerie, -n	аптекарский магазин
der Vermieter, - die Vermieterin, -nen	арендодатель
verhaften, verhaftet, verhaftete, hat verhaftet	арестовывать
der Architekt, -en die Architektin, -nen	архитектор
die Matura (A, CH) → D: Abitur	аттестат зрелости
der Flughafen, ¨-	аэропорт
die Oma, -s	бабка
das Gepäck	багаж
das Ballett, -e	балет
der Balkon, -e	балкон
die Banane, -n	банан
die Bank, -en	банк
die Bank, -en	банк
die ec-Karte/EC-Karte → A: Bankomat-Karte	банковская карта
die Bankleitzahl, -en	банковский идентификационный код
der Bancomat/Bankomat, -en	банкомат
der Geldautomat, -en (D) → A, CH: Bancomat/Bankomat	банкомат
die Bar, -s	бар
die Bar, -s	бар 
der Basketball, ¨-e	баскетбол
das Schwimmbad, ¨-er	бассейн плавательный
streiken, streikt, streikte, hat gestreikt	бастовать
die Batterie, -n	батарейка
der Turm, ¨-e	башня
joggen	бегать трусцой
die Flucht	бегство
Not-	беда
arm	бедный
laufen, läuft, lief, ist gelaufen	бежать
rennen, rennt, rannte, ist gerannt	бежать
miss-	без
ohne	без
fünf Minuten vor/nach eins	без пяти час 00:55 / час ноль пять 01:05
viertel vor/nach zwei	без четверти два
umsonst	безвозмездно
faulenzen, faulenzt, faulenzte, hat gefaulenzt	бездельничать
die Sicherheit, -en	безопасность
die Arbeitslosigkeit	безработица
arbeitslos	безработный
verrückt	безрассудно
wahnsinnig	безумный
weiß	белый
die Wäsche	белье
das Benzin, -s, -e	бензин
das Ufer, -	берег
sparsam	бережливый
die Schwangerschaft, -en	беременность
Berlin, 10. April 2012	Берлин
gratis	бесплатно
kostenlos	бесплатный
die Störung, -en	беспокойство
sinnlos	бессмысленный
toll	бешеный
die Bibliothek, -en	библиотека
der Bikini, -s	бикини
das Ticket, -s	билет
die Fahrkarte, -n → CH: Billet	билет для проезда в общественном транспорте
das Billett, -e/-s → D, A: Fahrkarte	билет проездной
Bio	био
der Lebenslauf, ¨-e	биография
bio(logisch)	биологический
die Biologie	биология
die Biologie	биология
schlagen, schlägt, schlug, hat geschlagen	бить
sich bedanken, bedankt, bedankte, hat bedankt	благодарить
danken, dankt, dankte, hat gedankt	благодарить
der Dank	благодарность
dankbar	благодарный
günstig	благоприятный
blass	бледный
nah(e)	ближний
die Nähe	близость
der Blog, -s	блог
blond	блондин
der Flohmarkt, ¨-e	блошиный рынок
sich irren, irrt sich, irrte sich, hat sich geirrt	блуждать
die Bluse, -n	блузка
die Bohne, -n	бобовые
der Gott, ¨-er	бог
reich	богатый
wach	бодрый
der Kampf, ¨-e	бой
die Krankheit, -en	болезнь
der Fan, -s	болельщик
wehtun, tut weh, tat weh, hat wehgetan	болеть
der Schmerz, -en	боль
das Krankenhaus, ¨-er	больница
die Krankenkasse, -n	больничная касса
krank	больной
der Kranke, -n die Kranke, -n	больной
der Strom	большая река
mehr (siehe auch viel)	больше
die Mehrheit, -en	большинство
groß	большой
der Bart, ¨-e	борода
der Schuh, -e	ботинок
die Mülltonne, -n	бочка для мусора
ängstlich	боязливый
(sich) fürchten, fürchtet, fürchtete, hat gefürchtet (vor D) (für A, um A)	бояться за чтолибо опасаться за когол
die Ehe, -n	брак
der Bruder, ¨-	брат
die Geschwister (Pl.)	брат и сестра
nehmen, nimmt, nahm, hat genommen	брать
(sich) rasieren, rasiert, rasierte, hat rasiert	брить
die Reservierung, -en	бронирование
reservieren, reserviert, reservierte, hat reserviert	бронировать
buchen, bucht, buchte, hat gebucht	бронировать гостиницу
(hinunter) runterwerfen, wirft runter, warf runter, hat runtergeworfen	бросать
werfen, wirft, warf, hat geworfen	бросать
auffallen, fällt auf, fiel auf, ist aufgefallen	бросаться в глаза
die Broschüre, -n	брошюра
die Hose, -n	брюки
hoffentlich	будем надеяться
der Wecker, -	будильник
wecken, weckt, weckte, hat geweckt	будить
die Zukunft	будущее
zukünftig	будущий
der Buchstabe, -n	буква
das Brötchen, - (D) → A: Semmel; CH: Brötli	булочка
das Brötli, - (CH) → D: Brötchen; A: Semmel	булочка
die Semmel, -n (A) → D: Brötchen; CH: Brötli	булочка
das Papier, -e	бумага
die Brieftasche, -n → D, CH: Portemonnaie/Portmonee; A: Geldbörse	бумажник
der Bundestag, -(e)s	бундестаг
der Bürgermeister, - die Bürgermeisterin, -nen	бургомистр
der Sturm, ¨-e	буря
die Flasche, -n	бутылка
das Buffet, -s	буфет
schnell	быстрый
sein, ist, war, ist gewesen	быть
zu sein, ist zu, war zu, ist zu gewesen	быть
aufpassen, passt auf, passte auf, hat aufgepasst	быть внимательным
passen, passt, passte, hat gepasst	быть впору
müssen, muss, musste, hat gemusst (hat müssen als Modalverb)	быть должным
sollen, soll, sollte, hat gesollt (hat sollen als Modalverb)	быть должным
ausreichen, reicht aus, reichte aus, hat ausgereicht	быть достаточным
sich kennen	быть знакомым
möglicherweise	быть может
anhaben, hat an, hatte an, hat angehabt	быть одетым
sich eignen, eignet sich, eignete sich, hat sich geeignet	быть свойственным
feststehen, steht fest, stand fest, ist festgestanden	быть установленным
das Fundbüro, -s	бюро находок
in	в
nach	в
zu	в
live	в живую
schließlich	в конце концов
wenigstens	в конце концов
jederzeit	в любое время
zurzeit	в настоящее время
zurzeit	в настоящее время
überhaupt	в общем
mittags, zu Mittag, am Mittag	в полдень
um Mitternacht	в полночь
unterwegs	в пути
falls	в случае если
tagsüber	в течение дня
halbtags	в течение половины дня
insgesamt	в целом
mitten	в центре
der Wagen, -	вагон
der Speisewagen, -	вагонресторан
wichtig	важный
die Vase, -n	ваза
die Badewanne, -n	ванна
kochen, kocht, kochte, hat gekocht	варить
die Einleitung, -en	введение
die Einführung, -en	введение
aufwärts	вверх
rauf/rauf-	вверх
der Import, -e	ввоз
einführen, führt ein, führte ein, hat eingeführt	ввозить
entlang	вдоль
vegetarisch	вегетарианский
der Moderator, -en, die Moderatorin, -nen	ведущий радио или телепередачи
höflich	вежливый
das Jahrhundert, -e	век
die Größe, -n	величина
das Fahrrad, ¨-er → D, A: Rad; CH: Velo	велосипед
das Rad, ¨-er (D, A) → Fahrrad; CH: Velo	велосипед
das Velo, -s (CH) → Fahrrad; D, A: Rad	велосипед
der Radfahrer, - die Radfahrerin, -nen	велосипедист
treu	верный
vermutlich	вероятно
wahrscheinlich	вероятно
ober-	верхний
das Gewicht, -e	вес
sich amüsieren, amüsiert sich, amüsierte sich, hat sich amüsiert	веселиться
froh	веселый
fröhlich	веселый
vergnügt	веселый
der Frühling, -s, -e /das Frühjahr, -(e)s, -e	весна
führen, führt, führte, hat geführt	вести
bloggen	вести блог
twittern	вести твиттер
all	весь
ganz	весь
gesamt-/Gesamt	весь
der Wind, -e	ветер
windig	ветренно
der Abend, -e	вечер
die Party, -s	вечеринка
abends, am Abend	вечером
ewig	вечный
das Ding, -e	вещь
die Sache, -n	вещь
wiegen, wiegt, wog, hat gewogen	взвешивание
der Blick, -e	взгляд
einbrechen, bricht ein, brach ein, ist eingebrochen	взламывать
der Einbruch, ¨-e	взлом
der Einbrecher, - die Einbrecherin, -nen	взломщик
die Gebühr, -en	взнос
der Erwachsene, -n	взрослый
die Aussicht, -en	вид
die Sportart, -en	вид спорта
das Video, -s	видеотехнология
schauen, schaut, schaute, hat geschaut	видеть
träumen, träumt, träumte, hat geträumt	видеть во сне
sichtbar	видимый
das Visum, Visa	виза
die Visitenkarte, -n	визитная карточка
das Quiz	викторина
die Gabel, -n	вилка
der Stecker, -	вилка штепсельная
die Schuld, -en	вина
schuld	виновный
schuldig	виновный
der Wein, -e	виноград
der Virus, Viren	вирус
hängen, hängt, hing/hängte, hat gehangen/gehängt	висеть
das Vitamin, -e	витамин
das Schaufenster, -	витрина
einschalten, schaltet ein, schaltete ein, hat eingeschaltet	включать
schalten, schaltet, schaltete, hat geschaltet	включать
einschließlich	включая
inklusive	включая
der Geschmack	вкус во рту
lecker	вкусный
besitzen, besitzt, besaß, hat besessen	владеть
die Gewalt, -en	власть
der Einfluss, ¨-e	влияние
verliebt	влюбленный
sich verlieben, verliebt sich, verliebte sich, hat sich verliebt	влюбляться
zusammen/zusammen-	вместе
statt	вместо
der Einfall, ¨-e	внезапная мысль
äußerlich	внешний
abwärts	вниз
herunter-, runter- (herunter-)laden, lädt herunter, lud herunter, hat heruntergeladen	вниз
unten	внизу
die Rücksicht, -en	внимание
aufmerksam	внимательный
eintragen, trägt ein, trug ein, hat eingetragen	вносить
der Enkel, - die Enkelin, -nen	внук
inner	внутренний
innen	внутри
innerhalb	внутри
während	во время
das Wasser	вода
der Fahrer, -	водитель
der Führerausweis, -e (CH) → D, A: Führerschein	водительское удостоверение
der Kanal, ¨-e	водоканал
der Umtausch, ¨-e	возврат
die Rückkehr	возвращение
die Luft, Lüfte	воздух
fahren, fährt, fuhr, ist/hat gefahren	возить
die Möglichkeit, -en	возможность
eventuell	возможный
möglich	возможный
virtuell	возможный
entstehen, entsteht, entstand, ist entstanden	возникать
erwachsen	возникать
widersprechen, widerspricht, widersprach, hat widersprochen	возражать
das Alter, -s	возраст
der Krieg, -e	война
der Bahnhof, ¨-e	вокзал
um	вокруг чеголибо
der Volleyball	волейбол
aufregen, regt auf, regte auf, hat aufgeregt	волновать
das Haar, -e	волос
erstens	вопервых
die Frage, -n	вопрос
der Dieb, -e	вор
das Tor, -e	ворота
der Sonntag, sonntags, am Sonntag	воскресенье
die Erziehung	воспитание
erziehen, erzieht, erzog, hat erzogen	воспитывать
die Rezeption/Reception, -en	восприятие
der Osten, Ost-/östlich	восток
begeistert	восторженный
vorwärts	вперед
voraus	впереди
vorn, vorne	впереди
durcheinander	вперемешку
der Eindruck, ¨-e	впечатление
der Arzt, ¨-e die Ärztin, -nen	врач
der Schaden, ¨-	вред
schaden, schadet, schadete, hat geschadet	вредить комулибо
schädlich	вредный
der Job, -s	временная работа 
vertreten, vertritt, vertrat, hat vertreten	временно заменять
die Dauer	время
die Zeit	время
der Zeitpunkt, -e	время
die Jahreszeit, -, -en	время года
die Tageszeit, -, -en	время дня
auseinander	врозь
sämtliche	все
immer	всегда
weltweit	всемирный
doch	всетаки
das Hilfsmittel, -	вспомогательное средство
aufstehen, steht auf, stand auf, ist aufgestanden	вставать
einfügen, fügt ein, fügte ein, hat eingefügt	вставлять
einsetzen, setzt ein, setzte ein, hat eingesetzt	вставлять
begegnen, begegnet, begegnete, ist begegnet	встречать
treffen, trifft, traf, hat getroffen	встречать
der Dienstag, -(e)s, -e, dienstags, am Dienstag	вторник
zweite	второй
drittens	втретьих
stecken, steckt, steckte, hat gesteckt	втыкать
der Eingang, ¨-e	вход
der Eintritt	вход
der Zugang, ¨-e	вход
treten, tritt, trat, hat/ist getreten	входить ступать
gestern	вчера
viertens	вчетвертых
die Einfahrt, -en	въезд
einziehen, zieht ein, zog ein, ist eingezogen	въезжать
(sich etwas) aussuchen, sucht aus, suchte aus, hat ausgesucht	выбирать
auswählen, wählt aus, wählte aus, hat ausgewählt	выбирать
wählen, wählt, wählte, hat gewählt	выбирать
die Auswahl, -en	выбор
die Wahl, -en	выбор
die Müllabfuhr	вывоз мусора
aussehen, sieht aus, sah aus, hat ausgesehen	выглядеть
ausgeben, gibt aus, gab aus, hat ausgegeben	выдавать
die Ausgabe, -n	выдача
die Ausfahrt, -en	выезд
die Herausforderung, -en	вызов
gewinnen, gewinnt, gewann, hat gewonnen	выигрывать
der Schalter, -	выключатель
ausfallen, fällt aus, fiel aus, ist ausgefallen	выпадать
der Ausdruck, ¨-e	выражение
landen, landet, landete, ist gelandet	высаживаться
die Aussage, -n	высказывание
hoch	высокий
die Höhe	высота
die Ausstellung, -en	выставление
ausstellen, stellt aus, stellte aus, hat ausgestellt	выставлять
ausziehen, zieht aus, zog aus, hat/ist ausgezogen	вытягивать
der Ausgang, ¨-e	выход
der Auftritt, -e	выход на сцену
ausgehen, geht aus, ging aus, ist ausgegangen	выходить из дому
in Rente gehen/sein (D) → D, A: in Pension gehen/ sein; CH, D: pensioniert werden/sein	выходить на пенсию
berechnen, berechnet, berechnete, hat berechnet	вычислять
klären, klärt, klärte, hat geklärt	выяснять
raten, rät, riet, hat geraten	гадать
das Gas, -е	газ
die Zeitung, -en	газета
die Galerie, -n	галерея
der Hamburger, -	гамбургер
die Garage, -n	гараж
garantieren, garantiert, garantierte, hat garantiert	гарантировать
die Garantie für etw. (А)	гарантия
die Garderobe, -n	гардероб
ausmachen, macht aus, machte aus, hat ausgemacht	гасить
löschen, löscht, löschte, hat gelöscht	гасить
der Nagel, ¨-	гвоздь
wo	где
die Geografie	география
Deutschland der Deutsche, -n die Deutsche, -n deutsch Deutsch	Германия немец
die Heldin, -nen	героиня
der Held, -en	герой
flexibel	гибкий
das Gymnasium	гимназия
die Gymnastik	гимнастика
der Link, -s	гиперссылка
die Gitarre, -n	гитара
das Kapitel, -	глава
eben	гладкий
glatt	гладкий
das Auge, -n	глаз
global	глобальный
tief	глубокий
dumm	глупый
taub	глухой
gucken, guckt, guckte, hat geguckt	глядеть
Guck mal!	Глянька!
treiben, treibt, trieb, hat getrieben	гнать
faul	гнилой
reden, redet, redete, hat geredet	говорить
sagen, sagt, sagte, hat gesagt	говорить
sprechen, spricht, sprach, hat gesprochen	говорить
das Jahr, -e jährlich	год
nutzen, nutzt, nutzte, hat genutzt	годиться
das Haupt, Häupter	голова
der Kopf, ¨-e	голова
der Hunger nach D	голод
hungrig	голодный
die Stimme, -n	голос
die Stimme, -n	голос
abstimmen, stimmt ab, stimmte ab, hat abgestimmt	голосовать
stimmen, stimmt, stimmte, hat gestimmt	голосовать
bloß	голый
Golf, das Golfspiel	гольф
der Berg, -e	гора
stolz	гордый
brennen, brennt, brannte, hat gebrannt	гореть
waagerecht	горизонтальный
das Gebirge	горная цепь
die Stadt, ¨-e	город
S-Bahn, -en	городская электричка
städtisch	городской
der Topf, ¨-e (D, A) → CH: Pfanne	горшок
bitter	горький
heiß	горячий
der Herr, -en	господин
der Gast, ¨-e	гость
der Beamte, -n die Beamtin, -nen	государственный служащий
der Staat, -en; staatlich	государство
(sich) vorbereiten, bereitet vor, bereitete vor, hat vorbereitet	готовить
zubereiten, bereitet zu, bereitete zu, hat zubereitet	готовить
bereit	готовый
fertig	готовый
gar	готовый о сваренном
der Bürger, - die Bürgerin, -nen	гражданин
der Personenstand → D, A: Familienstand; CH: Zivilstand	гражданское состояние
der Zivilstand (CH) → Personenstand; D, A: Familienstand	гражданское состояние
1 g = ein Gramm	грамм
die Grenze, -n	граница
die Grafik, -en	графика
donnern, donnert, donnerte, hat gedonnert	греметь
Griechenland der Grieche, -n die Griechin, -nen griechisch Griechisch	Греция грек
der Pilz, -e → A: Schwammerl	гриб
das Schwammerl, -n (A) → Pilzschwanger	гриб
der Grill	гриль
grillieren, grilliert, grillierte, hat grilliert (CH) → D, A: grillen	гриль делать
schminken, schminkt, schminkte, hat geschminkt	гримировать
die Grippe	грипп
das Gewitter, -	гроза
der Donner, -	гром
laut	громкий
das Baby, -s	грудной ребёнок
die Brust	грудь
aufladen, lädt auf, lud auf, hat aufgeladen	грузить
der Lkw, -s	грузовой автомобиль
der Grund, ¨-e	грунт
die Gruppe, -n	группа
die WG, -s	группа совместно проживающих людей
die Birne, -n	груша
schmutzig	грязный
der Dreck	грязь
der Schmutz	грязь
die Lippe, -n	губа
wandern, wandert, wanderte, ist gewandert	гулять
dicht	густой
ja	да
geben, gibt, gab, hat gegeben	давать
füttern, füttert, fütterte, hat gefüttert	давать корм
Bescheid geben	давать справку
drücken, drückt, drückte, hat gedrückt	давить
der Druck	давление
sogar	даже
weiter/weiter	далее
weit	далекий
die Dame, -n	дама
die Daten (Plural)	данные
schenken, schenkt, schenkte, hat geschenkt	дарить
das Datum, die Daten	дата
die Tür, -en	дверь
der Motor, -en	двигатель
bewegen, bewegt, bewegte, hat bewegt	двигать
die Bewegung, -en	движение
der Verkehr	движение транспорта
zweifach	двойной
doppelt	двойной
doppelt	двойной
der Hof, ¨-e	двор
der Cousin, -s die Cousine, -n	двоюродный брат
das Mädchen, -	девочка
der Opa, -s	дед
die Wirkung, -en	действие
wirklich	действительно
die Wirklichkeit, -en	действительность
gültig	действительный
handeln, handelt, handelte, hat gehandelt	действовать
wirken, wirkt, wirkte, hat gewirkt	действовать
dekorieren, dekoriert, dekorierte, hat dekoriert	декорировать
leisten, leistet, leistete, hat geleistet	делать
machen, macht, machte, hat gemacht	делать
tun, tut, tat, hat getan	делать
erhöhen, erhöht, erhöhte, hat erhöht	делать выше
winken, winkt, winkte, hat gewinkt	делать знак
leid tun, tut leid, tat leid, hat leidgetan	делать неприятно
operieren, operiert, operierte, hat operiert	делать операцию
die Abteilung, -en	деление
teilen, teilt, teilte, hat geteilt	делить
das Geschäft, -e	дело
das Werk, -e	дело
die Demokratie, -n, demokratisch	демократия
der Beitrag, ¨-e	денежный взнос
der Tag, -e,	день
der Tag, -e täglich	день
der Geburtstag, -e	День рождения
das Geld	деньги
das Dorf, ¨-er	деревня
der Baum, ¨-e	дерево
das Holz	дерево
halten, hält, hielt, hat gehalten	держать
wetten, wettet, wettete, hat gewettet	держать пари
frech	дерзкий
das Dessert, -s → D, A: Nachspeise	десерт
die Nachspeise, -n (D, A) → Dessert	десерт
das Jahrzehnt, -e	десятилетие
das Detail, -s	деталь
das Teil, -e	деталь
der Krimi, -s	детектив
der Nachwuchs	дети
der Kindergarten, ¨-	детский сад
die Kindheit	детство
billig	дешевый
die Tätigkeit, -en	деятельность
der Jazz	джаз
die Marmelade, -n (D, A)	джем
die Jeans (Pl.)	джинсы
der Dialekt, -e	диалект
der Dialog, -e	диалог
die Couch, -s	диван
das Sofa, -s	диван
wunderschön	дивный
die Diät	диета
wild	дикий
merkwürdig	диковинный
buchstabieren, buchstabiert, buchstabierte, hat buchstabiert	диктовать
der Lautsprecher, -	динамик
das Diplom, -e	диплом
der Direktor, -en die Direktorin, -nen	директор
die Scheibe, -n	диск
die Diskussion, -en	дискуссия
die Fernbedienung, -en	дистанционное управление
die Distanz, -en	дистанция
die Länge, -en	длина
lang	длинный
dauernd	длительный
dauern, dauert, dauerte, hat gedauert	длиться
für	для
bis	до
vormittags, am Vormittag	до полудня
bisher	до сих пор
zusätzlich	добавочный
freiwillig	добровольный
das Vertrauen	доверие
vertrauen, vertraut, vertraute, hat vertraut	доверять
genug	довольно
ziemlich	довольно
zufrieden	довольный
vereinbaren, vereinbart, vereinbarte, hat vereinbart	договариваться
der Vertrag, ¨-e	договор
(sich) verabreden, verabredet, verabredete, hat verabredet	договориться
der Regen	дождь
der Beweis, -e	доказательство
beweisen, beweist, bewies, hat bewiesen	доказывать
der Bericht, -e	доклад
das Referat, -e	доклад
der Vortrag, ¨-e	доклад
der Doktor, -en die Doktorin, -nen	доктор
das Dokument, -e	документ
die Urkunde, -n	документ законный
die Unterlagen (Pl.)	документы
die Pflicht, -en	долг
die Schulden (Pl.)	долги
lange, lang	долго
das Amt, ¨-er	должность
das Tal, ¨-er	долина
das Haus, ¨-er	дом
das Altenheim, -e → Altersheim	дом престарелых
das Haustier, -e	домашнее животное
die Hausaufgabe, -n	домашнее задание
der Haushalt, -e	домашнее хозяйство
das Zuhause	домашний очаг
die Homepage, -s	домашняя страница
die Hausfrau, -en der Hausmann	домашняя хозяйка
heim	домой
der Abwart, -e die Abwartin, -nen Hausmeister	домоправитель
der Hausmeister, - die Hausmeisterin, -nen (D, A) → CH: Abwart	домоправитель
ergänzen, ergänzt, ergänzte, hat ergänzt	дополнять
der Weg, -e	дорога
teuer	дорогой
das Verkehrszeichen, -	дорожный знак
die Tafel, -n	доска
besorgen, besorgt, besorgte, hat besorgt	доставать
erreichen, erreicht, erreichte, hat erreicht	доставать
die Lieferung, -en	доставка
ausreichend	достаточный
(4) ausreichend (die/eine Vier)	достаточный как оценка
die Verabredung, -en	достижение договоренности встреча
wert	достойный
die Sehenswürdigkeit, -en	достопримечательность
zugänglich	доступный
das Einkommen, -	доход
die Tochter, ¨-	дочь
der Freund, -e	друг
voneinander	друг от друга
miteinander	друг с другом
ander-	другой
anders	другой
die Freundschaft, -en	дружба
freundlich	дружелюбный
das Leder	дубленая кожа
der Bogen, -/¨-	дуга
denken, denkt, dachte, hat gedacht	думать
glauben, glaubt, glaubte, hat geglaubt (an А)	думать
nachdenken, denkt nach, dachte nach, hat nachgedacht	думать
stinken, stinkt, stank, hat gestunken	дурно пахнуть
das Parfüm, -s	духи
der (Back-)Ofen, ¨- (D, CH) → A: (Back-)Rohr	духовка
die Dusche, -n	душ
das (Back-)Rohr, -e (A) → D, CH: (Back-)Ofen	дымоход
das Loch, ¨-er	дыра
der Atem, -s	дыхание
atmen, atmet, atmete, hat geatmet	дышать
der Onkel, -	дядя
1 € = 1 Euro, -s	евро
Europa der Europäer, - die Europäerin, -nen europäisch	Европа европеец европейский
die Europäische Union, die EU	Евросоюз
das Essen, -	еда
die Mahlzeit, -en	еда
eben	едва
kaum	едва
einzig	единственный
einheitlich	единый
der Feiertag, -e	ежегодный праздник
täglich	ежедневно
reiten, reitet, ritt, ist geritten	ездить верхом
natürlich	естественный
essen, isst, aß, hat gegessen	есть
genießen, genießt, genoss, hat genossen	есть
fressen, frisst, fraß, hat gefressen	есть о животных
noch	еще
noch mal	еще раз
nochmals	еще раз
der Durst	жажда
durstig	жаждущий
vermissen, vermisst, vermisste, hat vermisst	жалеть об отсутствии
klagen, klagt, klagte, hat geklagt	жаловаться
schade	жаль
das Fieber	жар
die Hitze	жара
braten, brät, briet, hat gebraten	жарить
grillen, grillt, grillte, hat gegrillt (D, A) → CH: grillieren	жарить на гриле
der Braten, -	жаркое
erwarten, erwartet, erwartete, hat erwartet	ждать
warten, wartet, wartete, hat gewartet	ждать
die Lust	желание
der Wunsch, ¨-e	желание
willkommen	желанный приятный
(sich) wünschen, wünscht, wünschte, hat gewünscht	желать
die Eisenbahn, -en	железная дорога
gelb	желтый
der Magen, ¨-	желудок
verheiratet	женат
heiraten, heiratet, heiratete, hat geheiratet	жениться
weiblich	женский
die Frau, -en	женщина
das Opfer, -	жертва
die Festplatte, -n	жёсткий диск
die Büchse, -n (D, CH) → A: Dose	жестяная банка
die Dose, -n → D, CH: Büchse	жестяная банка
die Marke, -n	жетон
der Bauch, ¨-e	живот
Tier, -(e)s, -e	животное
das Tier, -e	животное
die Flüssigkeit, -en	жидкость
das Leben	жизнь
das Wohnzimmer, -	жилая комната
die Unterkunft, ¨-e	жилое помещение
das Quartier, -e (CH) → D, A: Viertel	жилье
das Fett, -e	жир
die Giraffe, -n	жираф
fett	жирный
der Bewohner, - die Bewohnerin, -nen	житель
der Einwohner, - die Einwohnerin, -nen	житель
leben, lebt, lebte, hat gelebt	жить
wohnen, wohnt, wohnte, hat gewohnt	жить
campen	жить в лагере [кемпинге]
zelten, zeltet, zeltete, hat gezeltet	жить в палатке
sich stehen	жить разг
getrennt leben	жить раздельно
die Zeitschrift, -en	журнал
der Journalist, -en die Journalistin, -nen	журналист
hinter/hinter- wo? D, wohin? A	за
pro	за
außerhalb	за пределами
dafür	за это
der Streik, -s	забастовка
sich verlaufen, verläuft sich, verlief sich, hat sich verlaufen	заблудиться
die Sorge, -n (um A)	забота
betreuen, betreut, betreute, hat betreut	заботиться
sorgen, sorgt, sorgte, hat gesorgt	заботиться
der Betreuer, - die Betreuerin, -nen	заботящийся
vergessen, vergisst, vergaß, hat vergessen	забывать
abhängig	зависимый
das Frühstück	завтрак
frühstücken, frühstückt, frühstückte, hat gefrühstückt	завтракать
das Rätsel, -	загадка
ansprechen, spricht an, sprach an, hat angesprochen	заговаривать
die Überschrift, -en	заголовок
der Ausflug, ¨-e	загородная прогулка
das Ausland	заграница
hochladen, lädt hoch, lud hoch, hat hochgeladen	загружать
die Umweltverschmutzung, -en	загрязнение окружающей среды
verschmutzen, verschmutzt, verschmutzte, hat verschmutzt	загрязнить
aufhalten, hält auf, hielt auf, hat aufgehalten	задерживать
festnehmen nimmt fest, nahm fest, hat festgenommen	задерживать
das Feuerzeug, -e	зажигалка
interessiert	заинтересованный
bestellen, bestellt, bestellte, hat bestellt	заказывать
enden, endet, endete, hat geendet	заканчивать
erledigen, erledigt, erledigte, hat erledigt	заканчивать
das Gesetz, -e	закон
schließen, schließt, schloss, hat geschlossen	закрывать
zumachen, macht zu, machte zu, hat zugemacht	закрывать
der Einkauf, ¨-e	закупка
die Halle, -n	зал большой
der Saal, Säle	зал помещение
der Ersatz	замена
ersetzen, ersetzt, ersetzte, hat ersetzt	заменять
die Notiz, -en	заметка
bemerken, bemerkt, bemerkte, hat bemerkt	замечать
merken, merkt, merkte, hat gemerkt	замечать
die Vertretung, -en	замещение
das Schloss, ¨-er	замок
beschäftigen, beschäftigt, beschäftigte, hat beschäftigt	заниматься
surfen	заниматься сёрфингом 
die Beschäftigung	занятие
der Unterricht	занятие
der Westen, West-/westlich	запад
der Notausgang, ¨-e	запасный выход
anschließen, schließt an, schloss an, hat angeschlossen	запирать замком
das Einschreiben, -	записать
der Zettel, -	записка
notieren	записывать
aufschreiben	записывать
ausfüllen, füllt aus, füllte aus, hat ausgefüllt	заполнять
die Tankstelle, -n	заправка
tanken, tankt, tankte, hat getankt	заправлять
untersagt	запрещать
verbieten, verbietet, verbot, hat verboten	запрещать
das Verbot, -e	запрещение
verboten	запрещено неуместно
verdienen, verdient, verdiente, hat verdient	зарабатывать
der Lohn, ¨-e	зарплата
der Stau, -s	застой
der Abschluss, ¨-e	затвор
abholen, holt ab, holte ab, hat abgeholt	заходить
eintreten, tritt ein, trat ein, ist eingetreten	заходить
vorlesen, liest vor, las vor, hat vorgelesen	зачитывать
der Schutz	защита
schützen, schützt, schützte, hat geschützt	защищать
der Antrag, ¨-e	заявление
die Bewerbung, -en	заявление
der Hase, -n	заяц
der Titel, -	звание
der Star, -s	звезда
der Stern, -e	звезда
klingeln, klingelt, klingelte, hat geklingelt	звонить
klingen, klingt, klang, hat geklungen	звонить
telefonieren, telefoniert, telefonierte, hat telefoniert	звонить по телефону
die Klingel, -n	звонок у двери
das Gebäude, -	здание
da	здесь
grüßen, grüßt, grüßte, hat gegrüßt	здороваться
gesund	здоровый
die Gesundheit	здоровье
grün	зеленый
das Grundstück, -e	земельный участок
der Boden, ¨-	земля
die Erde	земля
das Land, ¨-er	земля
der Spiegel, -	зеркало
der Winter, -s, -	зима
(sich) ärgern, ärgert, ärgerte, hat geärgert	злить
ärgerlich	злой
die Schlange, -n	змея
die Schlange, -n	змея
das Zeichen, -	знак
das Kennzeichen, -	знак отличительный
kennenlernen, lernt kennen, lernte kennen, hat kennengeler	знакомиться с кемл
bekannt	знакомый
der Bekannte, -n die Bekannte, -n	знакомый
berühmt	знаменитый
das Wissen	знание
die Kenntnisse (Pl.)	знания
kennen, kennt, kannte, hat gekannt	знать
wissen, weiß, wusste, hat gewusst	знать
die Bedeutung, -en	значение
bedeuten, bedeutet, bedeutete, hat bedeutet	значить
das Gold	золото
der Schirm, -e	зонт
der Tierpark, -s	зоопарк
der Zoo, -s	зоопарк
reif	зрелый
der Zuschauer, - die Zuschauerin, -nen	зритель
der Zahn, ¨-e	зуб
die Zahncreme/-pasta	зубная паста
die Zahnbürste, -n	зубная щетка
und	и
sowieso	и без того
und so weiter	и так далее
die Nadel, -n	игла
das Spiel, -e	игра
spielen, spielt, spielte, hat gespielt	играть
der Spielplatz, ¨-e	игровая площадка
der Spieler, - die Spielerin, -nen	игрок
das Spielzeug, -e	игрушка
ideal	идеальный
hageln, hagelt, hagelte, hat gehagelt Es hagelt.	Идет град
die Idee, -n	идея
gehen, geht, ging, ist gegangen	идти
zugehen, geht zu, ging zu, ist zugegangen	идти
regnen, es regnet, es regnete, es hat geregnet	идти дождю
entgegenkommen	идти навстречу
aus	из
von	из
vermeiden, vermeidet, vermied, hat vermieden	избегать
anzeigen, zeigt an, zeigte an, hat angezeigt	извещать
die Meldung, -en	извещение
die Entschuldigung, -en	извинение
entschuldigen, entschuldigt, entschuldigte, hat entschuldigt	извинять
wegen	изза
die Änderung, -en	изменение
(sich) verändern, verändert, veränderte, hat verändert	изменять
ursprünglich	изначальный
erschöpft	изнуренный
darstellen, stellt dar, stellte dar, hat dargestellt	изображать
die Abbildung, -en	изображение
die Darstellung, -en	изображение
erfinden, erfindet, erfand, hat erfunden	изобретать
die Erfindung, -en	изобретение как процесс
studieren, studiert, studierte, hat studiert	изучать
oder	или
entweder ... oder	или или
haben, hat, hatte, hat gehabt	иметь
der Name, -n	имя
der Vorname, -n	имя
sonst	иначе
die Zutaten (Pl.)	ингридиенты
individuell	индивидуальный
die Industrie, -n	индустрия
der Ingenieur, -e	инженер
manchmal	иногда
der Ausländer, - die Ausländerin, -nen ausländisch	иностранец
fremd	иностранный
die Fremdsprache, -n	иностранный язык
das Institut, -e	институт
das Instrument, -e	инструмент
das Werkzeug, -e	инструмент
die Integration, -en	интеграция
integrieren, integriert, integrierte, hat integriert	интегрировать
intensiv	интенсивный
das Interview, -s	интервью
das Interesse, -n	интерес
interessant	интересный
interessieren, interessiert, interessierte, hat interessiert für A (sich) (чем-л. für A, к чему-л. an D)	интересовать
international	интернациональный
das Internet	интернет
die Infektion, -en	инфекция
die Auskunft, ¨-e	информация
die Information, -en	информация
informieren, informiert, informierte, hat informiert	информировать
suchen, sucht, suchte, hat gesucht	искать
googeln	искать в Гугле
die Ausnahme, -n	исключение
künstlich	искусственный
der Kunststoff, -e	искусственный синтетический материал
die Kunst, ¨-e	искусство
die Untersuchung, -en	ислледование
verschreiben, verschreibt, verschrieb, hat verschrieben	исписывать
gebrauchen, gebraucht, gebrauchte, hat gebraucht	использовать
verwenden, verwendet, verwendete, hat verwendet	использовать
kaputt	испорченный
testen, testet, testete, hat getestet	испытывать
die Forschung, -en	исследование научное
untersuchen, untersucht, untersuchte, hat untersucht	исследовать
wahr	истинный настоящий
historisch	исторический
die Geschichte	история
die Geschichte, -n	история
verschwinden, verschwindet, verschwand, ist verschwunden	исчезать
der Juli	июль
der Juni	июнь
gegen	к
zum Beispiel	к примеру
leider	к сожалению
die Kneipe, -n (D)	кабак
das Kabel, -	кабель
jeder, jedes, jede	каждый
jedes Mal	каждый раз
jeweils	каждый раз
als	как
wie	как
als ob	как будто бы
sowohl … als auch	как так и
sobald	как только
der Kakao, -s	какао
was für ein-	какой
welcher, welche, welches	какой ая
der Kalender, -	календарь
der Terminkalender, -	календарьпамятка
der Stein, -e	камень
die Kamera, -s	камера
der Kandidat, -en	кандидат
die Ferien (Pl.) (CH) → D, A: Urlaub	каникулы
die Tropfen (Pl.)	капля
der Bleistift, -e	карандаш
die Tasche, -n	карман
das Taschengeld, -er	карманные деньги
der Karneval, -s/-e (D) → D, A: Fasching; CH: Fasnacht	карнавал
der Fasching, - (D, A) → D: Karneval; CH: Fasnacht	карнавал в последние дни перед Великим постом
die Fasnacht (CH) → D, A: Fasching; D: Karneval	карнвальная ночь
die Karotte, -n → D: Möhre; CH: Rüebli	каротель сорт моркови
die Bankomat-Karte, -n	карта банковская
die Karte, -n	карта географ
die Versichertenkarte, -n (D) → A: e-card	карта страхования
das Bild, -er	картина
der Erdapfel, ¨- (A) → Kartoffel	картофель
die Kartoffel, -n → A: Erdapfel	картофель
die Pommes frites (Pl.)	картофель фри
die Karriere, -n	карьера
die Kasse, -n	касса
die Castingshow, -s	кастинг
der Katalog, -e	каталог
die Katastrophe, -n	катастрофа
das Café, -s	кафе
das Kaffeehaus, ¨-er (A)	кафе
das Lokal, -e	кафе
die Cafeteria, -s	кафетерий
die Qualität, -en	качество
der Husten	кашель
husten, hustet, hustete, hat gehustet	кашлять
die Kabine, -n	каюта
1 m² = ein Quadratmeter	квадратный метр
die Qualifikation, -en	квалификация
die Wohnung, -en	квартира
die Quittung, -en	квитанция
der/das Ketchup/Ketschup, -s	кетчуп
1 kg = ein Kilo(gramm)	килограмм
1 km/h = ein Kilometer pro Stunde	километр в час
das Kino, -s	кино
der Kiosk, -e	киоск
sauer	кислый
die Tastatur, -en	клавиатура
die Klasse, -n	класс
klasse	классный
legen, legt, legte, hat gelegt	класть
kleben, klebt, klebte, hat geklebt	клеить
der Kloß, ¨-e (D) → D, A: Knödel	клецка
der Knödel, - (D, A) → D: Kloß	клецка
der Kunde, -n die Kundin, -nen	клиент
der Klick, - s	клик мышкой
anklicken, klickt an, klickte an, hat angeklickt	кликнуть мышью
das Klima	климат
die Klinik, -en	клиника
der Club, -s	клуб
der Schlüssel, -	ключ
das Buch, ¨-er	книга
der Verlag, -e (A: ¨-e)	книгоиздательство
die Buchhandlung, -en	книжный магазин
der Teppich, -e	ковер
wann	когда
wenn	когда
irgendwann	когданибудь
je	когданибудь
jemals	когданибудь
die Vorwahl, -en	код города
die Haut, Häute	кожа
die/das Cola, -s	кокакола
die Wurst, ¨-e	колбаса
das Knie, -	колено
das Rad, ¨-er	колесо
die Menge, -n	количество
der Kollege, -n die Kollegin, -nen	коллега
riesig	колоссальный
stechen, sticht, stach, hat gestochen	колоть
der Ring, -e	кольцо
das Team, -s	команда
die Mannschaft, -en	команда
die Mücke, -n	комар
der/das Comic, -s	комикс
komisch	комичный
der Kommentar, -e	комментарий
das Zimmer, -	комната
zuständig	компетентный
der Kompromiss, -e	компромисс
der PC, -s	компьютер
der Computer, -	компьютер
der Briefumschlag, ¨-e → A: Kuvert; CH: Couvert	конверт
das Couvert, -s (CH) → Briefumschlag; A: Kuvert	конверт
das Kuvert, -s (A) → der Briefumschlag; CH: Couvert	конверт
die Klimaanlage, -n	кондиционер
das Ende	конец
der Schluss	конец
der Feierabend	конец рабочего дня
das Wochenende, -n	конец рабочей недели
der Terminal, -s	конечный пункт
die Konkurrenz	конкуренция
der Wettbewerb, -e	конкурс
konservativ	консервативный
das Konsulat, -e	консульство
die Beratung	консультация
der Kontakt, -e	контакт
kontrollieren, kontrolliert, kontrollierte, hat kontrolliert	контролировать
checken	контролировать проверять технику понимать
die Kontrolle, -n	контроль
die Klassenarbeit, -en (D) → A: Schularbeit	контрольная работа
die Schularbeit, -en (A) → D: Klassenarbeit	контрольная работа в школе
die Konferenz, -en	конференция
die Konfitüre, -n (CH)	конфитюр
der Konflikt, -e	конфликт
sich konzentrieren, konzentriert sich, konzentrierte sich, hat sich konzentriert	концентрировать
das Konzert, -e	концерт
der Kopierer, -	копировальный аппарат
kopieren	копировать
die Kopie, -n	копия
das Schiff, -e	корабль
der Flur, -e → Gang; D, CH: Korridor	коридор
der Korridor, -e (D, CH) → Gang; D: Flur	коридор
braun	коричневый
ernähren, ernährt, ernährte, hat ernährt	кормить
verpflegen, verpflegt, verpflegte, hat verpflegt	кормить
die Ernährung	кормление
die Schachtel, -n	коробка
die Kuh, ¨-e	корова
das Rind, -er	корова
der König, -e	король
kurz	короткий
korrigieren, korrigiert, korrigierte, hat korrigiert	корректировать
schief	косой
der Knochen, -	кость
der Anzug, ¨-e	костюм
das Kostüm, -e	костюм женский
der Kaffee	кофе
die Geldbörse, -n (A) → Brieftasche; D, CH: Portemonnaie/ Portmonee	кошелек
das Portemonnaie/Portmonee, -s (D, CH) → Brieftasche; A: Geldbörse	кошелек
die Katze, -n	кошка
der Rand, ¨-er	край
extrem	крайний
der Notfall, ¨-e	крайняя необходимость
hübsch	красивый
schön	красивый
rot	красный
stehlen, stiehlt, stahl, hat gestohlen	красть
kreativ	креативный
der Kredit, -e	кредит
die Kreditkarte, -n	кредитная карта
die Creme, -n/-s	крем
haltbar	крепкий
kräftig	крепкий
sich festhalten (an D)	крепко держаться
die Burg, -en	крепость
der Fauteuil, -s (A, CH) → D, CH: Sessel	кресло
der Sessel, - (D, CH) → A, CH: Fauteuil	кресло
das Kreuz, -e	крест
der Bauer, -n	крестьянин
der Bauernhof, ¨-e	крестьянская усадьба
die Kurve, -n	кривая
die Krise, -n	кризис
die Kritik, -en	критика
kritisieren, kritisiert, kritisierte, hat kritisiert	критиковать
kritisch	критический
rufen, ruft, rief, hat gerufen	кричать
schreien, schreit, schrie, hat geschrien	кричать
bluten, blutet, blutete, hat geblutet	кровоточить
das Blut	кровь
außer	кроме
außerdem	кроме того
nebenbei	кроме того
der Kreis, -e Landkreis	круг
die Runde, -n	круг
rund	круглий
steil	крутой
das Hallenbad, ¨-er	крытый бассейн
das Dach, ¨-er	крыша
wer	кто
man	ктолибо каждый
jemand	ктонибудь
wohin	куда
die Puppe, -n	кукла
die Kultur, -en	культура
kulturell	культурный
das Bad, ¨-er	купание
baden, badet, badete, hat gebadet	купать
der Raucher, - die Raucherin, -nen	курильщик
das Hend(e)l, - (A) → D: Hähnchen/Hühnchen; CH: Poulet	курица
der Kurs, -e	курс занятий
der Kursleiter, - die Kursleiter, -nen	курс лечения
die Jacke, -n	куртка
beißen, beißt, biss, hat gebissen	кусать
das Stück/-stück, -e	кусок
die Küche, -n	кухня
Speise-/-speise, -n	кушанье
das Lager, -	лагерь
die Lampe, -n	лампа
die Nudel, -n	лапша
lügen, lügt, log, hat gelogen	лгать
der Löwe, -n	лев
der Snack, -s	легкая закуска
leicht	легкий
das Eis	лед
liegen, liegt, lag, hat/ist gelegen	лежать
klettern, klettert, kletterte, ist geklettert	лезть
die Droge, -n	лекарство
die Band, -s	лента
der Wald, ¨-er	лес
die Stiege, -n (A) → D, CH: Treppe	лестница
das Stiegenhaus, ¨-er (A) → D, CH: Treppenhaus	лестница
die Treppe, -n (D, CH) → A: Stiege	лестница
das Treppenhaus, ¨-er (D, CH) → A: Stiegenhaus	лестничная клетка
fliegen, fliegt, flog, ist geflogen	летать
der Sommer, -s, -	лето
ob	ли
liberal	либеральный
lila	лиловый
die Zitrone, -n	лимон
die Limonade, -n	лимонад
die Linie, -n	линия
das Blatt, ¨-er	лист
der Antwortbogen, -/-“-	лист ответов
die Literatur	литература
1 l = ein Liter	литр
gießen, gießt, goss, gegossen	лить
das Gesicht, -er	лицо
persönlich	личный
fangen, fängt, fing, hat gefangen	ловить
das Boot, -e	лодка
der Löffel, -	ложка
die Lüge, -n	ложь
brechen, bricht, brach, hat gebrochen	ломать
das Pferd, -e	лошадь
die Wiese, -n	луг
der Rasen, -	лужайка
die Zwiebel, -n	лук
der Mond, -e	луна
der Ski/Schi, -er/-	лыжа
Lieblings-	любимец
beliebt	любимый
lieb	любимый
lieben, liebt, liebte, hat geliebt	любить
die Liebe, -n	любовь
gespannt	любопытный
neugierig	любопытный
die Leute (Pl.)	люди
Elektrogeschäft, Elektroingenieur, Elektroherd	магазин электроники
die Salbe, -n	мазь
der Mai, -(e)s и –, -en и -e	май
maximal	максимальный
klein	маленький
ein bisschen	мало
wenig/wenige	мало
gering	малый
der Bub, -en (A, CH) → D: Junge	мальчик
der Junge, -n (D) → A, CH: Bub	мальчик
das Schreiben, -	манера писать
die Margarine, -en	маргарин
der März, -(es), -en, -e	март
das Öl, -e	масло растительное
die Butter	масло сливочное
der Meister, -	мастер
basteln, bastelt, bastelte, hat gebastelt	мастерить
das Studio, -s	мастерская
die Werkstatt, ¨-en	мастерская
der Rechner, -	математик
die Mathe(matik)	математика
das Material, - ien	материал
das Zeug/-zeug	материя
die Mutter, ¨-	мать
das Mountainbike, -s	маунтинбайк
die Maschine, -n	машина
das Möbel, -	мебель
möbliert	меблированная
der Honig	мед
der Bär, -en	медведь
das Medikament, -e	медикамент
die Medizin, -en	медицина
langsam	медленный
zwischen	между
übrigens	между прочим
inzwischen	между тем
mittlerweile	между тем
interkulturell	межкультурный
der Händler, - die Händlerin, -nen	мелкий торговец
die Minderheit, -en	меньшиство
das Menü, -s	меню
die Speisekarte, -n	меню
ändern, ändert, änderte, hat geändert	менять
tauschen, tauscht, tauschte, hat getauscht	менять
umtauschen, tauscht um, tauschte um, hat umgetauscht	менять
wechseln, wechselt, wechselte, hat gewechselt	менять
frieren, friert, fror, hat gefroren	мерзнуть
messen, misst, maß, hat gemessen	мерить
tot	мертвый
die Messe, -n	месса
die Gegend, -en	местность
die Landschaft, -en	местность
der Ort, -e	место
die Stelle, -n	место
der Treffpunkt, -e	место встречи
der Wohnort, -e	место жительства
der Wohnort, -e	место жительства
der Wohnsitz, -e	место жительства
die Lehrstelle, -n	место производственного обучения ученика
die Arbeitsstelle, -n	место работы
die Lage	местоположение
der Monat, -e monatlich	месяц
das Metall, -e	металл
der Wetterbericht, -e	метеосводка
die Methode, -n	метод
1 m = ein Meter, das/der Meter, -s, =	метр
1,15 m = ein Meter fünfzehn	метр 15
die U-Bahn, -en	метро
die U-Bahn, -en	метрополитен
die Metropole, -n	метрополия
das Laufwerk, -e	механизм машины
der Mechaniker, - die Mechanikerin, -nen	механик
mischen, mischt, mischte, hat gemischt	мешать
stören, stört, störte, hat gestört	мешать
der Sack, ¨-e	мешок
der Augenblick, -e	миг
der Migrant, -en die Migrantin, -nen	мигрант
die Migration	миграция
1 000 000 000 = eine Milliarde, -n	миллиард
1 000 000 = eine Million, -en	миллион
nett	милый
vorbei/vorbei-	мимо
das Mineralwasser, -wässer>	минеральная вода
minimal	минимальный
der Minister, - die Ministerin, -nen	министр
minus	минус
-1°C = ein Grad unter Null/ minus ein Grad	минус один градус
die Minute, -n	минута
der Friede, -e Frieden, -	мир
die Welt	мир
die Schüssel, -n	миска
die Meinung, -en	мнение
viel/viele	много
zahlreich	многочисленный
das Handy, -s	мобильный телефон
das Mobiltelefon, -e	мобильный телефон
die Mode, -n	мода
das Modell, -e	модель
das Modul, -e	модуль
vielleicht	может быть
nass	мокрый
der Blitz, -e	молния
jung	молодой
die Jugend	молодость
die Milch	молоко
der Hammer, ¨-	молот
schweigen, schweigt, schwieg, hat geschwiegen	молчать
der Moment, -e	момент
die Münze, -n	монета
der Monitor, -e	монитор
das Meer, -e	море
die See die Nord-/Ostsee	море
die Möhre, -n (D) → Karotte; CH: Rüebli	морковь
das Rüebli, - (CH) → Karotte; D: Möhre	морковь
das Eis (D, A) → CH: Glace/ Glacé	мороженое
die Kälte	мороз
die Brücke, -n	мост
das Pflaster, -	мостовая булыжная
das Motorrad, ¨-er	мотоцикл
dürfen, darf, durfte, hat gedurft (hat dürfen als Modalverb)	мочь
können, kann, konnte, hat gekonnt (hat können als Modalverb)	мочь
das Waschmittel, -	моющее средство
weise	мудрый
mutig	мужественный
der Mut	мужество
männlich	мужской
der Mann, ¨-er	мужчина
das Museum, Museen	музей
die Musik	музыка
die Musik	музыка
musikalisch	музыкальный
der Musiker, - die Musikerin, nen	музыкант
das Mehl, -е	мука
der Muskel, -n	мускул
der Müll	мусор
der Abfalleimer, -	мусорное ведро
die Fliege,- n	муха
peinlich	мучительный
die Seife, -n	мыло
der Gedanke, -n	мысль
die Maus, ¨-e	мышь
das Müesli/Müsli, -	мюсли
mild	мягкий
weich	мягкий
der Fleischhauer, - die Fleischhauerin, -nen (A) → Metzger	мясник
der Metzger, - → A: Fleischhauer	мясник
das Fleisch	мясо
der Ball, ¨-e	мяч
auf	на
Prost	на здоровье! ваше здоровье!
beobachten, beobachtet, beobachtete, hat beobachtet	наблюдать
oben	наверху
besuchen, besucht, besuchte, hat besucht	навещать
sich langweilen, langweilt, langweilte, hat gelangweilt	нагонять тоску
einladen, lädt ein, lud ein, hat eingeladen	нагружать
über	над
(sich) anziehen, zieht an, zog an, hat angezogen	надевать
die Hoffnung, -en	надежда
sicher	надежный
zuverlässig	надежный
hoffen, hofft, hoffte, hat gehofft	надеяться
die Erhöhung, -en	надстройка
zurück/zurück	назад
festsetzen, setzt fest, setzte fest, hat festgesetzt	назначать
angeben, gibt an, gab an, hat angegeben	называть
nennen, nennt, nannte, hat genannt	называть
heißen, heißt, hieß, hat geheißen	называться
die Strafe, -n	наказание
bestrafen, bestraft, bestrafte, hat bestraft	наказывать
sich beschweren, beschwert sich, beschwerte sich, hat sich beschwert	накладывать груз
endlich	наконец
das Bargeld, -(e)s	наличные деньги
bar	наличный
die Steuer, -n	налог
die Mehrwertsteuer	налог на добавленную стоимость
vorhaben, hat vor, hatte vor, hat vorgehabt	намереваться сделать чтолибо носить повязанный фартук и тп
die Absicht, -en	намерение
das Vorhaben	намерение
das Getränk, -e	напиток
erfüllen, erfüllt, erfüllte, hat erfüllt	наполнять
erinnern, erinnert, erinnerte, hat erinnert	напоминать
zuletzt	напоследок
die Richtung, -en	направление
leiten, leitet, leitete, hat geleitet	направлять
vergeblich	напрасный
gegenüber	напротив
sich anstrengen, strengt sich an, strengte sich an, hat sich angestrengt	напрягать
das Suchtmittel, -	наркотик
die Volkshochschule, -en	Народный университет
raus-	наружу
neben	наряду
das Insekt, -en	насекомое
die Bevölkerung	население
der Schnupfen	насморк
die Aufforderung, -en	настоятельная просьба
die Mahnung, -en	настоятельная просьба
auffordern, fordert auf, forderte auf, hat aufgefordert	настоятельно просить
Tee ziehen lassen	настояться чаю
echt	настоящий
die Stimmung, -en	настроение
die Wissenschaft, -en	наука
finden, findet, fand, hat gefunden	находить
heraus-, raus- (heraus-) finden, findet heraus, fand heraus, hat herausgefunden	находить
sich befinden, befindet sich, befand sich, hat sich befunden	находиться
national/national	национальный
der Nationalfeiertag, -(e)s, -e	национальный праздник
der Anfang, ¨-e	начало
die Aufnahme, -n	начало
der Beginn, -(e)s	начало
die Grundschule, -n	начальная школа
anfangen, fängt an, fing an, hat angefangen	начинать
beginnen, beginnt, begann, hat begonnen	начинать
nicht	не
ausschließen, schließt aus, schloss aus, hat ausgeschlossen	не впускать
unterlassen, unterlässt, unterließ, hat unterlassen	не делать
wertlos	не имеющий ценности
der Himmel	небо
das Gasthaus, ¨-er (A)	небольшая гостиница
die Gaststätte, -n (D)	небольшая гостиница с рестораном
der Swimmingpool, -s	небольшой открытый плавательный бассейн
der Hügel, -	небольшой холм
unglaublich	невероятный
negativ	негативный
kürzlich	недавно
neulich	недавно
die Woche, -n wöchentlich	неделя
preiswert	недорогой
fehlen, fehlt, fehlte, hat gefehlt	недоставать
der Mangel, ¨-	недостаток
(6) ungenügend (die/eine Sechs)	недостаточно как оценка
(5) mangelhaft (die/eine Fünf)	недостаточный
die Panne, -n	неисправность
der Rasen, -	неистовство
mehrere	некоторые
manch-	некоторый
hässlich	некрасивый
der Nichtraucher, - die Nichtraucherin, -nen	некурящий
illegal	нелегальный
stumm	немой
hassen, hasst, hasste, hat gehasst	ненавидеть
notwendig	необходимый
ungewöhnlich	необычный
die Überraschung,-en	неожиданность
plötzlich	неожиданный
der Nerv, -en	нерв
nervös	нервный
unentschieden	нерешенный
(ein) paar	несколько
trotz	несмотря
trotzdem	несмотря на это
der Unfall, ¨-e	несчастный случай
das Unglück, -e	несчастный случай
nein	нет
weder … noch	ни ни
nirgends	нигде
nirgendwo	нигде
niedrig	низкий
kein-	никакой ая
nie	никогда
niemand	никто
nichts	ничто
aber	но
die Nachricht, -en	новость
die Neuigkeit, -en	новость
neu	новый
Neujahr, -(e)s	Новый год
das Bein, -e	нога
der Fuß, ¨-e	нога
das Messer, -	нож
die Schere, -n	ножницы
00:03 = null Uhr drei	ноль часов три минуты
die Nummer, -n	номер дома
die Rufnummer, -n	номер телефона
normal	нормальный
die Nase, -n	нос
tragen, trägt, trug, hat getragen	носить
das Taschentuch, ¨-er	носовой платок
die Socke, -n	носок
die Note, -n	нота
der Laptop, -s	ноутбук
die Übernachtung, -en	ночлег
die Nacht, ¨-e	ночь
der November	ноябрь
gefallen, gefällt, gefiel, hat gefallen	нравиться
benötigen, benötigt, benötigte, hat benötigt	нуждаться
brauchen, braucht, brauchte, hat gebraucht	нуждаться
nötig	нужный
riechen, riecht, roch, hat gerochen	нюхать
der Babysitter, -/die Babysitterin, -nen	няня
worum	о чем
beid-	оба
überholen, überholt, überholte, hat überholt	обгонять
das Schmerzmittel, -	обезболивающее
der Affe, -n	обезьяна
sichern, sichert, sicherte, hat gesichert	обеспечивать
versprechen, verspricht, versprach, hat versprochen	обещать
die Wolke, -n	облако
das Gebiet, -e	область
die Region, -en	область
bewölkt	облачный
erleichtern, erleichtert, erleichterte, hat erleichtert	облегчать
betrügen, betrügt, betrog, hat betrogen	обманывать
umarmen	обнимать
einrichten, richtet ein, richtete ein, hat eingerichtet	оборудовать
die Begründung, -en	обоснование
die Bildung, -en	образование
die Rückmeldung, -en	обратная связь
rückwärts	обратно
rück- die Rückfahrt, -en	обратно обратный путь
behandeln, behandelt, behandelte, hat behandelt	обращаться
(sich) siezen, siezt, siezte, hat gesiezt	обращаться на "Вы"
duzen, duzt, duzte, hat geduzt	обращаться на ты
die Anrede, -n	обращение
einfallen, fällt ein, fiel ein, ist eingefallen	обрушиваться
bedienen, bedient, bediente, hat bedient	обслуживать
besprechen, bespricht, besprach, hat besprochen	обсуждать
diskutieren, diskutiert, diskutierte, hat diskutiert	обсуждать
die Besprechung, -en	обсуждение
ausgebildet	обучать
die Ausbildung, -en	обучение
die Lehre	обучение
besetzen, besetzt, besetzte, hat besetzt	обшивать
(sich) unterhalten, unterhält, unterhielt, hat unterhalten	общаться
chatten	общаться в сети
öffentlich	общедоступный
Gesamtschule	общеобразовательная школа
die Öffentlichkeit	общественность
die Gesellschaft, -en	общество
allgemein	общий
gemeinsam	общий
die Gemeinde, -n	община
die Gemeinschaft, -en	общность
das Inserat, -e	объвление
sich einigen, einigt sich, einigte sich, hat sich geeinigt	объединять
die Ansage, -n	объявление передачи
ankündigen, kündigt an, kündigte an, hat angekündigt	объявлять
bekannt geben, gibt bekannt, gab bekannt, hat bekannt gegeben	объявлять
die Erklärung, -en	объяснение
erklären, erklärt, erklärte, hat erklärt	объяснять
normalerweise	обычно
gewöhnlich	обычный
üblich	обычный
verpflichtet	обязанный
die Bremse, -n	овод
das Gemüse	овощи
das Schaf, -e	овца
das Feuer	огонь
begrenzt	ограниченный
beschränken	ограничивать
leihen, leiht, lieh, hat geliehen	одалживать
die Kleidung	одежда
süchtig	одержимый страстью
allein	один
ein-	один
einmal	один раз
ein Uhr	один час
einsam	одинокий
Einzel	одиночная игра
¼ = ein Viertel; Viertel … usw.	одна четвертая
einmal zweimal dreimal viermal usw.	однажды
allerdings	однако
jedoch	однако же
gleichzeitig	одновременный
genehmigen, genehmigt, genehmigte, hat genehmigt	одобрять
der See, -n	озеро
beeinflussen, beeinflusst, beeinflusste, hat beeinflusst	оказывать влияние
unterstützen, unterstützt, unterstützte, hat unterstützt	оказывать помощь
beenden, beendet, beendete, hat beendet	оканчивать
der Ozean, -e	океан
der Anruf, -e	оклик
anrufen, ruft an, rief an, hat angerufen	окликать
das Fenster, -	окно
endgültig	окончательный
der Schinken, -	окорок
die Umgebung, -en	окрестности
der Oktober	октябрь
sich lohnen, lohnt sich, lohnte sich, hat sich gelohnt	окупаться
rauchen, raucht, rauchte, hat geraucht	окуривать
online	онлайн
verpassen, verpasst, verpasste, hat verpasst	опаздывать
die Gefahr, -en	опасность
gefährlich	опасный
die Oper, -n	опера
die Operation, -en	операция
die Beschreibung, -en	описание
beschreiben, beschreibt, beschrieb, hat beschrieben	описывать
die Verspätung, -en	опоздание
bestimmt	определенный
stürzen, stürzt, stürzte, ist gestürzt	опрокидывать
die Umfrage, -n	опрос
die Spritze, -n	опрыскиватель
optimistisch	оптимистический
veröffentlichen, veröffentlicht, veröffentlichte, hat veröffentlicht	опубликовать
die Erfahrung, -en	опыт
wieder/wieder	опять
orange	оранжевый
die Orange, -n	оранжевый
die Organisation, -en	организация
die Veranstaltung, -en	организация
organisieren, organisiert, organisierte, hat organisiert	организовывать
das Original, -e	оригинал
original	оригинальный
das Orchester, -	оркестр
befreien	освобождать
die Entlassung, -en	освобождение
der Herbst, -es, -e	осень
beleidigen, beleidigt, beleidigte, hat beleidigt	оскорблять
besichtigen, besichtigt, besichtigte, hat besichtigt	осматривать
sinnvoll	осмысленный
gründlich	основательный
begründen, begründet, begründete, hat begründet	основывать
gründen, gründet, gründete, hat gegründet (auf A, auf D)	основывать
besonders	особенно
die Personalien (Pl.)	особенности
besonder	особенный
speziell	особый
bleiben, bleibt, blieb, ist geblieben	оставаться
hinter/hinterhinterlassen, hinterlässt, hinterließ, hat hinterlassen	оставить после себя
behalten, behält, behielt, hat behalten	оставлять
übrig	остальной
stoppen, stoppt, stoppte, hat gestoppt	останавливать
stehen bleiben	останавливаться
der Halt	остановка
die Haltestelle, -n	остановка
der Rest, -e	остаток
die Vorsicht	осторожность
vorsichtig	осторожный
die Insel, -n	остров
scharf	острый
spitz	острый
verurteilen, verurteilt, verurteilte, hat verurteilt	осуждать
schneien, es schneit, es schneite, es hat geschneit	осыпаться
ab	от
der Abfall, ¨-e	отбросы
die Antwort, -en	ответ
verantwortlich	ответственный
der Ordner, -	ответственный за соблюдение порядка
beantworten, beantwortet, beantwortete, hat beantwortet	отвечать
antworten, antwortet, antwortete, hat geantwortet	отвечать на чтол
die Trennung, -en	отделение
extra	отдельно
einzeln	отдельный
abmachen, macht ab, machte ab, hat abgemacht	отделять
lösen, löst, löste, hat gelöst	отделять
(sich) trennen, trennt, trennte, hat getrennt	отделять
die Erholung, -en	отдых
(sich) ausruhen, ruht aus, ruhte aus, hat ausgeruht	отдыхать
sich erholen, erholt sich, erholte sich, hat sich erholt	отдыхать
das Hotel, -s	отель
der Vater, ¨-	отец
verzichten, verzichtet, verzichtete, hat verzichtet	отказываться
sich weigern, weigert sich, weigerte sich, hat sich geweigert	отказываться
klappen, klappt, klappte, hat geklappt	откидывать
sparen, spart, sparte, hat gespart	откладывать
ablehnen, lehnt ab, lehnte ab, hat abgelehnt	отклонять
entdecken, entdeckt, entdeckte, hat entdeckt	открывать
eröffnen, eröffnet, eröffnete, hat eröffnet	открывать
öffnen, öffnet, öffnete, hat geöffnet	открывать
die Eröffnung, -en	открытие выставки
offen	открытый
woher	откуда
ausgezeichnet	отличный
super	отличный
absagen, sagt ab, sagte ab, hat abgesagt	отменять
ankreuzen	отметить крестиком
markieren, markiert, markierte, hat markiert	отмечать
abwaschen, wäscht ab, wusch ab, hat abgewaschen	отмывать
relativ	относительный
die Beziehung, -en	отношения
die Heizung, -en	отопление
ausdrucken, druckt aus, druckte aus, hat ausgedruckt	отпечатывать полностью
der Absender, - die Absenderin, -nen	отправитель
die Sendung, -en	отправление
faxen	отправлять по факсу
losfahren, fährt los, fuhr los, ist losgefahren	отправляться в путь
der Urlaub, -e (D, A) → CH: Ferien	отпуск
entlassen, entlässt, entließ, hat entlassen	отпускать
Abgase (Pl.)	отработавший газ
die Pension, -en	отставка
die Verantwortung	отственность
abwesend	отсутствующий
daher	оттуда
die Abfahrt, -en	отход
abfahren, fährt ab, fuhr ab, ist abgefahren	отъезжать
das Büro, -s	офис
offiziell	официальный
der Kellner, - die Kellnerin, -nen → D, A: Ober; CH: Serviceangestellter	официант
der Ober, - (D, A) → Kellner - CH: Serviceangestellter	официант
der Umweltschutz	охрана окруж среды
schätzen, schätzt, schätzte, hat geschätzt	оценивать
offenbar	очевидный
sehr	очень
sich klären	очищаться
die Brille, -n	очки
der Fehler, -	ошибка
fallen, fällt, fiel, ist gefallen	падать
sinken, sinkt, sank, ist gesunken	падать
der Fall, ¨-e	падение
das Puzzle, -s	пазл
das Paket, -e	пакет
die Tüte, -n	пакет
das Zelt, -e	палатка
das Camp, -s	палаточный лагерь 
der Finger, -	палец
der Mantel, ¨-	пальто
das Denkmal, ¨-er	памятник
die Erinnerung, -en	память
die Mappe, -n	папка
das Paar, -e	пара
parallel	параллельный
der Coiffeur, -e die Coiffeuse, -n (CH) → D, A: Friseur	парикмахер
der Friseur, -e die Friseurin, -nen (D, A) → CH: Coiffeur	парикмахер
der Park, -s	парк
parkieren, parkiert, parkierte, hat parkiert (CH) → D, A: parken	парковать
das Parlament, das Europäische Parlament	парламент
Doppel	парная игра
die Fähre, -n	паром
die Partei, -en	партия
der Partner, - die Partnerin, -nen	партнер
der Pass, ¨-e	паспорт заграничный
der Passagier, -e die Passagierin, -nen	пассажир
passiv	пассивный
das Ostern	Пасха
die Pause, -n	пауза
pauschal	паушальный
der Patient, -en die Patientin, -nen	пациент
der Sänger, - die Sängerin, -nen	певец
die Bäckerei, -en	пекарня
der Rentner, - die Rentnerin, -nen (D, CH) → A: Pensionist	пенсионер
der Pensionist, -en / die Pensionistin, -nen (A) → D, CH: Rentner	пенсионер отставной чиновник
die Pension, -en (A, CH) → D, CH: Rente	пенсия
der Vormittag, -e	первая половина дня
prima	первоклассный
der/die/das erste	первый
erst	первый
das Erdgeschoss/ Ergeschoß, -e	первый этаж
die Übersetzung, -en	перевод
die Überweisung, - en	перевод
übersetzen, übersetzt, übersetzte, hat übersetzt	переводить
überweisen, überweist, überwies, hat überwiesen	переводить
der Übersetzer, - die Übersetzerin, -nen	переводчик о человеке
umziehen, zieht um, zog um, ist umgezogen	перевозить
verbinden, verbindet, verband, hat verbunden	перевязывать
vor vor allem	перед
ausrichten, richtet aus, richtete aus, hat ausgerichtet	передавать
abgeben, gibt ab, gab ab, hat abgegeben	передать
die Durchsage, -n	передача сообщения
die Durchsage, -n	передача сообщения по радио
mobil/mobil	передвижной
vorderen	передних
der Umzug, ¨-e	переезд
ziehen, zieht, zog, hat/ist gezogen	переезжать
das Erlebnis, -se	переживание
erleben, erlebt, erlebte, hat erlebt	переживать
die Umleitung, -en	перенаправление
übertragen	переносить
sich umziehen, zieht sich um, zog sich um, hat sich umgezogen	переодеваться
abschreiben, schreibt ab, schrieb ab, hat abgeschrieben	переписывать
überfahren, überfährt, überfuhr, hat überfahren	переправлять
verwechseln, verwechselt, verwechselte, hat verwechselt	перепутать
umsteigen, steigt um, stieg um, ist umgestiegen	пересаживаться
überqueren, überquert, überquerte, hat überquert	пересекать
der Pfeffer	перец
senkrecht	перпендикулярный
der Bahnsteig, -e	перрон
der Perron, -s (CH) → D, A: Bahnsteig	перрон
die Person, -en	персона
das Personal	персонал
der Song, -s	песня
das Lied, -er	песня
der Sand	песок
bunt	пестрый
farbig	пестрый
das Hähnchen/Hühnchen, - (D) → A: Hend(e)l; Poulet, -s (CH)	петушок
singen, singt, sang, hat gesungen	петь
kümmern, kümmert, kümmerte, hat gekümmert	печалить
sich kümmern, kümmert sich, kümmerte sich, hat sich gekümmert um A	печалиться
traurig	печальный
drucken, druckt, druckte, hat gedruckt	печатать
der Stempel, -	печать
das Gebäck	печенье
backen, bäckt/backt, backte, hat gebacken	печь
der Fußgänger, - die Fußgängerin, -nen	пешеход
die Fußgängerzone, -n	пешеходная зона
das Klavier, -e	пианино
das Bier	пиво
das Picknick, -s die Pille, -n	пикник
der Pinguin, -e	пингвин
der Kuchen, -	пирог
der Schriftsteller, - die Schriftstellerin, -nen	писатель
schreiben, schreibt, schrieb, hat geschrieben	писать
schriftlich	письменный
der Brief, -e	письмо
die Schrift, -en	письмо
trinken, trinkt, trank, hat getrunken	пить
die Pizza, -s/Pizzen	пицца
schwimmen, schwimmt, schwamm, ist geschwommen	плавать
fließend	плавный
das Plakat, -e	плакат
weinen, weint, weinte, hat geweint	плакать
der Plan, ¨-e	план
der Stadtplan, ¨-e	план города
der Fahrplan, ¨-e	план поездки
die Planung, -en	планирование
planen, plant, plante, hat geplant	планировать
die Miete, -n	плата за наем
die Einzahlung, -en	платеж
die Zahlung, -en	платеж
bezahlen, bezahlt, bezahlte, hat bezahlt	платить
einzahlen, zahlt ein, zahlte ein, hat eingezahlt	платить
zahlen, zahlt, zahlte, hat gezahlt	платить
das Tuch, ¨-er	платок
das Kleid, -er	платье
der CD-Player, -	плеер
der Neffe, -n	племянник
die Nichte, -n	племянница
der Film, -e	пленка
die Schulter, -n	плечо
der Herd, -e	плита
die Frucht, ¨-e	плод
Früchte (CH) → D, A: Obst	плоды
flach	плоский
böse	плохой
schlecht	плохой
schlimm	плохой
die Plattform, -en	площадка
die Fläche, -n	площадь
der Platz, ¨-e	площадь
plus	плюс
(+) 4°C = vier Grad über Null/ plus vier Grad	плюс 4 градуса
der Strand, ¨-e	пляж
wochentags, werktags	по будням
möglichst	по возможности
am Wochenende	по выходным
mindestens	по меньшей мере
zumindest	по меньшей мере
nachts, in der Nacht	по ночам
der Sieg, -e	победа
der Sieger, - die Siegerin, -nen	победитель
siegen, siegt, siegte, hat gesiegt	побеждать
die Küste, -n	побережье
nebenan	поблизости
der Koch, ¨-e die Köchin, -nen	повар
das Verhalten	поведение
drehen, dreht, drehte, hat gedreht	поворачивать
(sich) umdrehen, dreht um, drehte um, hat umgedreht	поворачивать
wenden, wendet, wendete, hat gewendet	поворачивать
(sich) verletzen, verletzt, verletzte, hat verletzt	повредить
beschädigen, beschädigt, beschädigte, hat beschädigt	повреждать
alltäglich	повседневный
überall	повсюду
die Wiederholung, -en	повтор
wiederholen, wiederholt, wiederholte, hat wiederholt	повторить
die Weiterbildung, -en	повышение уровня знаний
das Wetter	погода
der Keller, -	погреб
tauchen, taucht, tauchte, ist/hat getaucht	погружать
unter	под
unter-	под
im Freien	под открытым небом
reichen, reicht, reichte, hat gereicht	подавать
beantragen, beantragt, beantragte, hat beantragt	подавать заявление
sich bewerben, bewirbt sich, bewarb sich, hat sich beworben	подавать заявление
das Geschenk, -e	подарок
die Ampel, -n	подвесная лампа
die Mobilität, -en	подвижность
die Vorbereitung, -en	подготовка
die Unterstützung, -en	поддержка
der Anschluss, ¨-e	подключение
fällig	подлежащий исполнению
eigentlich	подлинный
aufheben, hebt auf, hob auf, hat aufgehoben	поднимать
aufnehmen, nimmt auf, nahm auf, hat aufgenommen	поднимать
heben, hebt, hob, hat gehoben	поднимать
steigen, steigt, stieg, ist gestiegen	подниматься
der Verdacht, -dächte	подозрение
verdächtig	подозрительный
unterschreiben, unterschreibt, unterschrieb, hat unterschrieben	подписывать
abonnieren, abonniert, abonnierte, hat abonniert	подписываться
die Unterschrift, -en	подпись
jobben	подрабатывать
die Einzelheit, -en	подробность
der Jugendliche, -n die Jugendliche, -nen	подросток
bestätigen, bestätigt, bestätigte, hat bestätigt	подтверждать
die Bestätigung, -en	подтверждение
das Kissen, -	подушка
unterstreichen, unterstreicht, unterstrich, hat unterstrichen	подчеркивать
der Lift, -e → D, A: Aufzug	подъемний кресельный горнолыжный
der Zug, ¨-e	поезд
die Reise, -n	поездка
bitte	пожалуйста
die Feuerwehr, -en	пожарная часть
vorgestern	позавчера
hinterher	позади
spät	поздний
der Glückwunsch, ¨-e	поздравление
die Gratulation, -en	поздравление
gratulieren, gratuliert, gratulierte, hat gratuliert (j-m zu D)	поздравлять
der Standpunkt, -e	позиция
sich kennenlernen	познакомиться друг с другом
solange	пока
zeigen, zeigt, zeigte, hat gezeigt	показывать
der Tote, -n die Tote, -n	покойник
die Generation, -en	поколение
die Decke, -n	покров
der Käufer, - die Käuferin, -nen	покупатель
einkaufen, kauft ein, kaufte ein, hat eingekauft	покупать
(sich etwas) kaufen, kauft, kaufte, hat gekauft	покупать
der Kauf, Käufe	покупка
das Geschlecht, -er	пол
meinen, meint, meinte, hat gemeint	полагать
der Mittag, -e	полдень
die Jause, -n (A) → D: Imbiss; CH: Znüni/Zvieri	полдник
das/der Zvieri/Znüni, -s (CH) → D: Imbiss; A: Jause	полдник
das Feld, -er	поле
nützlich	полезный
der Tipp, -s	полезный совет
der Flug, ¨-e	полет
der Politiker, - die Politikerin, -nen	политик
die Politik	политика
politische	политический
politisch	политический
der Polizist, -en die Polizistin, -nen	полицейский
die Polizei	полиция
das Fach, ¨-er	полка
das Regal, -e	полка
die Mitternacht, -, ..nächte	полночь
komplett	полный
unbedingt	полный
voll	полный
völlig	полный
die Vollzeit	полный рабочий день
½ = ein halb; halb …	половина
halb	половина
die Hälfte, -n	половина
halb drei	половина третьего
positiv	положительный
überlegen, überlegt, überlegte, hat überlegt	положить
spülen, spült, spülte, hat gespült	полоскать
das Semester, -	полугодие
die Halbpension	полупансион
der Empfänger, -	получатель
bekommen, bekommt, bekam, hat bekommen	получать
erhalten, erhält, erhielt, hat erhalten sich erhalten	получать
kriegen, kriegt, kriegte, hat gekriegt	получать
einnehmen, nimmt ein, nahm ein, hat eingenommen	получать доход
der User, -/die Userin, -nen	пользователь
benutzen, benutzt, benutzte, hat benutzt	пользоваться
nützen, nützt, nützte, hat genützt	пользоваться
helfen, hilft, half, hat geholfen	помогать
die Aushilfe, -n	помощь
die Förderung, -en	помощь
die Hilfe	помощь
die Nachhilfe, -n	помощь
der Montag, montags, am Montag	понедельник
das Verständnis	понимание
begreifen	понимать
(sich) verstehen, versteht, verstand, hat verstanden	понимать
der Begriff, -(e)s, -e	понятие
verständlich	понятный
quer	поперечный
populär	популярный
der Versuch, -e	попытка
der Laster, -	порок грузовик разг
der Hafen, ¨-	порт
kaputtmachen sich kaputtmachen	портить
kaputtgehen	портиться
der Auftrag, ¨-e	поручение
die Portion, -en	порция еды
die Ordnung	порядок
fair	порядочный
die Ordination, -en (A) → Praxis	посвящение в сан
der Besuch, -e	посещение
die Botschaft, -en	послание
nachher	после
nachmittags, am Nachmittag	после обеда
nachdem	после того как
danach	после этого
letzt-	последний
die Reihenfolge, -n	последовательность
übermorgen	послезавтра
der Nachmittag, -e	послеобеденное время
die Eile	поспешность
eilig	поспешный
mittler-	посреднический
die Vermittlung, -en	посредничество
liefern, liefert, lieferte, hat geliefert	поставлять
der Anbieter, -	поставщик услуг
das Bett, -en	постель
das Poster, -	постер
ständig	постоянный
die Taste, -n	поступок
das Geschirr, -е	посуда
schicken, schickt, schickte, hat geschickt	посылать
senden, sendet, sendete/ sandte, hat gesendet/ gesandt	посылать
mailen	посылать сообщение по электронной почте
der Verlust, -e	потеря
der Verlierer, - die Verliererin, -nen	потерявший
verlieren, verliert, verlor, hat verloren	потерять
schwitzen, schwitzt, schwitzte, hat geschwitzt	потеть
weil	потому что
der Konsum	потребление
konsumieren, konsumiert, konsumierte, hat konsumiert	потреблять
verbrauchen, verbraucht, verbrauchte, hat verbraucht	потреблять
der Bedarf, -(e)s	потребность
der Gang, ¨-e	походка
ähnlich	похожий
der Kuss, ¨-e	поцелуй
warum	почему
weshalb	почему
wieso	почему
worüber	почему
die Reparatur, -en	починка
die Post	почта
der Briefträger, → CH: die Briefträgerin, -nen Pöstler	почтальон
der Pöstler, - / die Pöstlerin, -nen (CH) → Briefträger	почтальон
beinahe	почти
fast	почти
die Briefmarke, -n	почтовая марка
die Postleitzahl, -en	почтовый индекс
der Briefkasten, ¨-	почтовый ящик
der Zoll, ¨-e	пошлина
deshalb	поэтому
deswegen	поэтому
die Zone, -n	пояс клим
die Wahrheit, -en	правда
zwar	правда
die Regel, -n	правило
korrekt	правильный
richtig	правильный
die Regierung, -en	правительство
der Anspruch, ¨-e	право
das Recht, -e	право на
die Vorfahrt	право преимущественного проезда
recht-	право сторонний
rechtlich	правовой
recht	правый
die Feier, -n	праздник
das Fest, -e	праздник
der Feiertag, -(e)s, -e	праздник ежегодный
feiern, feiert, feierte, hat gefeiert	праздновать
das Praktikum, Praktika	практика
die Praxis, Praxen	практика врача
die Praxis, Praxen → A: Ordination	практика врача
der Praktikant, -en die Praktikantin, -nen	практикант
praktisch	практический
der Aufenthalt, -e	пребывание
perfekt	превосходный
vorläufig	предварительный
anbieten, bietet an, bot an, hat angeboten	предлагать
bieten, bietet, bot, hat geboten	предлагать
präsentieren	предлагать
vorschlagen, schlägt vor, schlug vor, hat vorgeschlagen	предлагать
das Angebot, -e	предложение
der Satz, ¨-e	предложение
der Vorschlag, ¨-e	предложение
der Gegenstand, ¨-e	предмет
warnen, warnt, warnte, hat gewarnt	предостерегать
verhindern, verhindert, verhinderte, hat verhindert	предотвратить
die Vorschrift, -en	предписание
die Voraussetzung, -en	предплоложение
voraussichtlich	предполагаемый
vermuten, vermutet, vermutete, hat vermutet	предполагать
der Unternehmer, - die Unternehmerin, -nen	предприниматель
unternehmen, unternimmt, unternahm, hat unternommen	предпринимать
der Betrieb, -e	предприятие
die Wettervorhersage, -n	предсказание
der Vertreter, - die Vertreterin, -nen	представитель
die Vorstellung, -en	представление
die Ahnung	предчувствие
bevor	прежде чем
die Präsentation, -en E	презентация
die Präsentation, -en	презентация
der Vorteil, -e	преимущество
aufhören, hört auf, hörte auf, hat aufgehört	прекращаться
übernachten, übernachtet, übernachtete, hat übernachtet	преночевать
unterrichten, unterrichtet, unterrichtete, hat unterrichtet	преподавать
behindern, behindert, behinderte, hat behindert behindert	препятствовать
unterbrechen, unterbricht, unterbrach, hat unterbrochen	прерывать
die Presse	пресс
der Täter, - die Täterin, -nen	преступник
der Verbrecher, - die Verbrecherin, -nen	преступник
realisieren, realisiert, realisierte, hat realisiert	претворять в жизнь
übertreiben, übertreibt, übertrieb, hat übertrieben	преувеличивать
dabei	при этом
der Zuschlag, ¨-e	прибавка
sich nähern, nähert sich, näherte sich, hat sich genähert	приближаться
das Gerät, -e	прибор
ankommen, kommt an, kam an, ist angekommen	прибывать
der Gewinn, -e	прибыль
die Ankunft	прибытие
der Gruß, ¨-e	приветствие
begrüßen, begrüßt, begrüßte, hat begrüßt	приветствовать
aufführen, führt auf, führte auf, hat aufgeführt	приводить
die Gewohnheit, -en	привычка
gewohnt	привычный
die Einladung, -en	приглашение
geeignet (zu D, für A)	пригодный к чемул
der Vorort, -e	пригород
der Vorort, -e	пригород
der Empfang, ¨-e	прием
die Notaufnahme, -n	приемное отделение неотложной помощи
die Ordination, -en (A) → Sprechstunde	приемные часы
die Sprechstunde, -n → A: Ordination	приемные часы
die Landung, -en	приземление
anerkennen, erkennt an, erkannte an, hat anerkannt	признавать
das Abenteuer, -	приключение
fleißig	прилежный
anwenden, wendet an, wandte an, hat angewandt/ angewendet	применять к чемул
das Beispiel, -e	пример
circa/zirka	примерно
etwa	примерно
ungefähr	примерно
gehören, gehört, gehörte, hat gehört (zu D)	принадлежать
annehmen, nimmt an, nahm an, hat angenommen	принимать
akzeptieren, akzeptiert, akzeptierte, hat akzeptiert	принимать
empfangen, empfängt, empfing, hat empfangen	принимать
übernehmen, übernimmt, übernahm, hat übernommen	принимать
beachten, beachtet, beachtete, hat beachtet	принимать во внимание
(sich) duschen, duscht, duschte, hat geduscht	принимать душ
zusagen, sagt zu, sagte zu, hat zugesagt	принимать приглашение
bringen, bringt, brachte, hat gebracht	приносить
holen, holt, holte, hat geholt	приносить
der Drucker, -	принтер
(sich) zwingen, zwingt, zwang, hat gezwungen	принуждать
sich entschließen, entschließt sich, entschloss sich, hat sich entschlossen	принять решение
anschaffen, schafft an, schaffte an, hat angeschafft	приобретать
die Natur	природа
anstellen, stellt an, stellte an, hat angestellt	приставлять
anschnallen, schnallt an, schnallte an, hat angeschnallt	пристегивать
anwesend	присутствующий
gewöhnen, gewöhnt, gewöhnte, hat gewöhnt/ ist gewöhnt (an А)	приучать к чемул когол
die Einnahme, -n	приход
kommen, kommt, kam, ist gekommen	приходить
die Frisur, -en	прическа
die Ursache, -n	причина
verursachen, verursacht, verursachte, hat verursacht	причинять ущерб
angenehm	приятный
das Problem, -e	проблема
kosten, kostet, kostete, hat gekostet (A) → D, CH: probieren	пробовать
schmecken, schmeckt, schmeckte, hat geschmeckt	пробовать
die Prüfung, -en	проверка экзамен
prüfen, prüft, prüfte, hat geprüft	проверять
überprüfen, überprüft, überprüfte, hat überprüft	проверять
verbringen, verbringt, verbrachte, hat verbracht	проводить время
begleiten, begleitet, begleitete, hat begleitet	провожать
das Programm, -e	программа
die Software, -s	программное обеспечение
der Spaziergang, ¨-e	прогулка
die Wanderung, -en	прогулка
verkaufen, verkauft, verkaufte, hat verkauft	продавать продаваться
der Verkäufer, - die Verkäuferin, -nen	продавец
fortsetzen, setzt fort, setzte fort, hat fortgesetzt	продолжать дело
die Fortsetzung, -en	продолжение
die Fortbildung, -en	продолжение обучение
das Produkt, -e	продукт
das Nahrungsmittel, -	продукт питания
die Lebensmittel (Pl.)	продукты питания
die Fahrkarte, -n → CH: Billett	проездной билет
passieren, passiert, passierte, ist passiert	проезжать
die Fahrbahn, -en	проезжая часть дороги
das Projekt, -e	проект
der Hersteller, -	производитель
herstellen, stellt her, stellte her, hat hergestellt	производить
produzieren, produziert, produzierte, hat produziert	производить
der Betriebsrat, ¨-e die Betriebsrätin, -nen	производственный совет
die Produktion, -en	производство
aussprechen, spricht aus, sprach aus, hat ausgesprochen	произносить
die Aussprache	произношение
sich ereignen, ereignet sich, ereignete sich, hat sich ereignet	происходить
stammen, stammt, stammte, hat gestammt	происходить
vorkommen, kommt vor, kam vor, ist vorgekommen	происходить
die Herkunft	происхождение
umso	пропорциональное усиление и употр с  или 
das Faschierte (A) → D, CH: Hackfleisch	пропускать через мясорубку
bitten, bittet, bat, hat gebeten	просить
der Prospekt, -e	проспект
einfach	простой
einfach	простой
der Raum, ¨-e	пространство
die Erkältung, -en	простуда
sich erkälten, erkältet sich, erkältete sich, hat sich erkältet	простужать
erkältet	простуженный
aufwachen, wacht auf, wachte auf, ist aufgewacht	просыпаться
die Bitte, -n	просьба
der Protest, -e	протест
protestieren, protestiert, protestierte, hat protestiert	протестовать
dagegen	против этого
der Gegner, -	противник
der Gegensatz, ¨-e	противоположность
das Gegenteil, -e	противоположность
umgekehrt	противоположный
die Berufsschule, -en	профессиональное училище
beruflich	профессиональный
die Gewerkschaft, -en	профессиональный союз
der Beruf, -e	профессия
der Professor, -en die Professorin, -nen	профессор
der Profi, -s	профи
kühl	прохладный
1 % = ein Prozent	процент
die Zinsen (nur Pl.)	проценты
der Prozess, -e	процесс
weg/weg-	прочь
die Vergangenheit, -en	прошлое
verzeihen, verzeiht, verzieh, hat verziehen	прощать
die Verzeihung	прощение
springen, springt, sprang, ist gesprungen	прыгать
geradeaus	прямо
direkt	прямой
das Gewürz, -e	пряность
(sich) verstecken, versteckt, versteckte, hat versteckt	прятать
der Vogel, ¨-	птица
das Publikum	публика
erschrecken, erschrickt, erschrak, ist erschrocken/ jdn. erschrecken, erschreckt, erschreckte, hat erschreckt	пугать
der Knopf, ¨-e	пуговица
der Pullover, -	пуловер
pünktlich	пунктуальный
lassen, lässt, ließ, hat gelassen	пустить
leer	пустой
mögen, mag, mochte, hat gemocht	пусть
möchten, möchte, mochte, hat gemocht	пусть любить
reisen, reist, reiste, ist gereist	путешествовать
die Bahn, -en	путь
die Biene, -n	пчела
der Staub, Stäube	пыль
probieren, probiert, probierte, hat probiert	пытаться
versuchen, versucht, versuchte, hat versucht	пытаться
betrunken	пьяный
der Freitag, freitags, am Freitag	пятница
der Fleck, -en	пятно
die Arbeit, -en	работа
der Traumberuf, -e	работа мечты
die Teilzeit	работа неполный рабочий день
arbeiten, arbeitet, arbeitete, hat gearbeitet	работать
berufstätig	работающий по специальности
der Arbeiter, - die Arbeiterin, -nen	работний
der Arbeitsplatz, ¨-e	рабочее место
der Wochentag, -(e)s, -e	рабочий
der Alltag, -(e)s	рабочий день
gleichberechtigt	равноправный
egal	равный
gleich	равный
meinetwegen	ради меня
das Radio, -s	радиоприемник
der Sender, -	радиостанция
sich freuen, freut sich, freute sich, hat sich gefreut	радоваться
lustig	радостный
die Freude, -n	радость
mal	раз
das Mal, -e	раз
geschieden	разведенный
geschieden	разведенный
entwickeln, entwickelt, entwickelte, hat entwickelt	развивать
die Entwicklung, -en	развитие
sich vergnügen, vergnügt sich, vergnügte sich, hat sich vergnügt	развлекаться
die Scheidung, -en	развод
sich scheiden lassen, lässt sich scheiden, ließ sich scheiden, hat sich scheiden lassen	разводиться
das Gespräch, -e	разговор
die Rede, -n	разговор
verteilen, verteilt, verteilte, hat verteilt	раздавать
der Ärger	раздражение
erkennen, erkennt, erkannte, hat erkannt	различать
unterscheiden, unterscheidet, unterschied, hat unterschieden	различать
der Unterschied, -e	различие
verschieden	различный
unterschiedlich	разный
die Enttäuschung, -en	разочарование
enttäuschen, enttäuscht, enttäuschte, hat enttäuscht	разочаровывать
der Durchschnitt, -e	разрез
entscheiden, entscheidet, entschied, hat entschieden	разрешать
erlauben, erlaubt, erlaubte, hat erlaubt	разрешать
die Erlaubnis	разрешение
die Arbeitserlaubnis	разрешение на работу
zerstören, zerstört, zerstörte, hat zerstört	разрушать
vernünftig	разумный
der Bereich, -e	район
die Wunde, -n	рана
früh	ранний
eher	раньше
früher/früher-	раньше
vorher	раньше
verraten, verrät, verriet, hat verraten	раскрыть
der Beleg, -e	расписка
ordnen, ordnet, ordnete, hat geordnet	располагать
die Laune, -n	расположение духа
der Tagesablauf, ¨-e	распорядок дня
die Erzählung, -en	рассказ
erzählen, erzählt, erzählte, hat erzählt	рассказывать
entspannend	расслаблять
zuschauen	рассматривать
die Nachfrage, -n	расспрашивание
der Abschied, -e	расставание
die Entfernung, -en	расстояние
die Strecke, -n	расстояние
rechnen, rechnet, rechnete, hat gerechnet	рассчитывать
auflösen, löst auf, löste auf, hat aufgelöst	растворять
die Pflanze, -n	растение
wachsen, wächst, wuchs, ist gewachsen	расти
kündigen, kündigt, kündigte, hat gekündigt	расторгать
die Kündigung, -en	расторжение
die Kosten (Pl.)	расходы
die Rechnung, -en	расчет
das Girokonto, -en	расчетный счет
das Rathaus, ¨-er	ратуша
reagieren, reagiert, reagierte, hat reagiert	реагировать
die Reaktion, -en	реакция
realistisch	реалистический
die Mittelschule, -en	реальное училище
die Realschule, -en	реальное училище
die Realität, -en	реальность
das Kind, -er	ребенок
regional	региональный
regeln, regelt, regelte, hat geregelt	регулировать
regelmäßig	регулярный
selten	редкий
(sich) schneiden, schneidet, schnitt, hat geschnitten	резать
das Ergebnis, -se	результат
die Leistung, -en	результат работы
der Fluss, ¨-e	река
die Reklame, -n	реклама
die Werbung, -en	реклама
der Spot, -s	рекламный ролик
die Empfehlung, -en	рекомендация
empfehlen, empfiehlt, empfahl, hat empfohlen	рекомендовать
der Rekord, -e	рекорд
die Religion, -en	религия
das Gleis, -e	рельс
der Handwerker, - die Handwerkerin, -nen	ремесленник
die Rente, -n (D, CH) → A, CH: Pension	рента
probieren, probiert, probierte, hat probiert (D, CH) → A: kosten	репетировать
die Reportage, -n	репортаж
der Reporter, - die Reporterin, -nen	репортер
das Restaurant, -s	ресторан
die Reform, -en	реформа
das Rezept, -e	рецепт
beschließen, beschließt, beschloss, hat beschlossen	решать
die Lösung, -en	решение
die Entscheidung, -en	решение
die Lösung, -en	решение
das Urteil, -e	решение суда
entschlossen	решительный
lösen	решить задачу
der Reis	рис
das Risiko, Risiken	риск
die Zeichnung, -en	рисование
malen, malt, malte, hat gemalt	рисовать
zeichnen, zeichnet, zeichnete, hat gezeichnet	рисовать чертить
die Heimat	родина
die Eltern (Pl.)	родители
Schwiegereltern, Schwiegermutter (vater, sohn, tochter)	родители супруга
geboren werden, wird geboren, wurde geboren, ist geboren worden	родиться
das Heim, -e	родной дом
die Muttersprache, -n	родной язык
der Verwandte, -n die Verwandte, -n	родственник
der Angehörige, -n die Angehörige, -n	родственники
verwandt	родственный
die Geburt, -en	роды
das Weihnachten	Рождество
die Rose, -n	роза
die Steckdose, -n	розетка штепсельная
rosa	розовый
die Recherche, -n	розыск
die Rolle, -n	ролик
der Roman, -e	роман жанр
der Mund, ¨-er	рот
das Hemd, -en	рубашка
das Hackfleisch (D, CH) → A: Faschierte	рубленое мясо
schimpfen, schimpft, schimpfte, hat geschimpft	ругать
der Arm, -e	рука
die Hand, ¨-e	руки
der Leiter, - die Leiterin, -nen	руководитель
die Leiter, -n	руководитель
der Manager, -/die Managerin, -nen	руководитель крупного предприятия 
die Anleitung, -en	руководство
die Bedienungsanleitung, -en	руководство
die Führung, -en	руководство
die Leitung, -en	руководство
der Fisch, -e	рыба
der Markt, ¨-e	рынок
der Rucksack, ¨-e	рюкзак
die Reihe, -n	ряд
daneben	рядом
per	с
seit	с
andererseits	с другой стороны
einerseits	с одной стороны
seitdem	с тех пор
eckig	с углами
gern/gerne	с удовольствием
damit	с этим
der Garten, ¨-	сад
einsteigen, steigt ein, stieg ein, ist eingestiegen	садиться в машину и пр
pflanzen, pflanzt, pflanzte, hat gepflanzt	сажать
(sich) setzen, setzt, setzte, hat gesetzt	сажать
der Salat, -e	салат блюдо
der Salon, -s	салон
selbst	сам
selbstverständlich	само собой разумеющийся
höchstens	самое большее
spätestens	самое позднее
das Flugzeug, -e	самолет
selber	самостоятельно
selbstständig	самостоятельный
nächst-	самый близкий
längst	самый длинный
der Krankenpfleger, -	санитар
der Pfleger, - die Pflegerin, -nen	санитар
die Krankenschwester, -n	санитарка
der Stiefel, -	сапог
der Zucker	сахар
die/das Glace/Glacé, -n (CH) → D, A: Eis das Glas, ¨-er	сахарная глазурь
das/der (Schlag-)Obers (A) → D: (Schlag-)Sahne; CH: (Schlag-)Rahm	сбитые сливки
die Hochzeit, -en	свадьба
frisch	свежий
blitzen, blitzt, blitzte, hat geblitzt	сверкать
die Überstunde, -n	сверхурочный час
das Licht, -er	свет
der Schein, -e	свет
scheinen, scheint, schien, hat geschienen	светить
hell-	светлый
hell	светлый
die Kerze, -n	свеча
der Zeuge, -n die Zeugin, -nen	свидетель
das Schwein, -e	свинья
die Freiheit	свобода
die Freizeit	свободное время
frei	свободный
los/los-	свободный
rechtzeitig	своевременный
abbiegen, biegt ab, bog ab, ist abgebogen	сворачивать
die Kommunikation, -en	связь
die Verbindung, -en	связь
der Zusammenhang, ¨-e	связь
aufgeben, gibt auf, gab auf, hat aufgegeben	сдавать
vermieten, vermietet, vermietete, hat vermietet	сдавать в аренду
die Aufgabe, -n	сдача багажа и т п 
die Vermietung, -en	сдача в аренду
verschieben, verschiebt, verschob, hat verschoben	сдвигать
sich verhalten, verhält sich, verhielt sich, hat sich verhalten	сдерживать
der Norden, Nord-/nördlich	север
heute	сегодня
heute ist der 1. März	сегодня 1 марта
heutig-	сегодняшний
die Saison, -s	сезон
sofort	сейчас
der Sekretär, -e die Sekretärin, -nen	секретарь
die Sekunde, -n	секунда
die Landwirtschaft	сельское хозяйство
der Familienstand (D, A) → Personenstand; CH: Zivilstand	семейное положение
das Seminar, -e	семинар
die Familie, -n	семья
der September	сентябрь
der Service	сервиз
herzlich	сердечный
das Herz, -en	сердце
die Mitte	середина
die Serie, -n	серия
das Zertifikat, -e	сертификат
grau	серый
ernst	серьезный
ernsthaft	серьезный
die Schwester, -n	сестра
das Netzwerk, -e	сети
das Netz, -e	сеть
(sich) verbrennen, verbrennt, verbrannte, hat verbrannt	сжигать
hinten	сзади
die Zigarette, -n	сигарета
der Alarm, -e	сигнал тревоги
hupen, hupt, hupte, hat gehupt	сигналить
der Sitz, -e	сиденье
sitzen, sitzt, saß, hat/ist gesessen	сидеть
die Kraft, ¨-e	сила
das, der Silvester, -s, -	Сильвестр праздник встречи Нового года
stark	сильный
das Symbol, -e	символ
sympathisch	симпатичный
blau	синий
das System, -e	система
die City, -s	сити
die Situation, -en	ситуация
das Märchen, -	сказка
die Bank, ¨-e	скамейка
der Rabatt, -e	скидка
das Magazin, -e	склад
die Pfanne, -n (CH) → D, A: Topf	сковорода
wie viel(e)	сколько
der Krankenwagen, -	скорая помощь автомобиль
bald	скоро
die Autobahn, -en	скоростная магистраль
die Geschwindigkeitsbeschränkung, -en	скоростной режим
die Geschwindigkeit, -en	скорость
die Kreuzung, -en	скрещение
die Langeweile	скука
das Plastik	скульптура
sich langweilen	скучать
langweilig	скучный
schwach	слабый
süß	сладкий
die Folie, -n	слайд
links	слева
tippen, tippt, tippte, hat getippt	слегка коснуться пальцами
die Spur, -en	след
also	следовательно
folgen, folgt, folgte, ist gefolgt	следовать
die Folge, -n	следствие
folgend	следующий
die Träne, -n	слеза
blind	слепой
die Pflaume, -n	слива
das Wörterbuch, ¨-er	словарь
das Wort, ¨-er	слово
das Wort, -e	слово
kompliziert	сложный
der Elefant, -en	слон
der Angestellte, -n die Angestellte, -n	служащий
der Serviceangestellte, -n / die Serviceangestellte, -n (CH) → Kellner; D, A: Ober	служащий
der Dienst	служба
dienen, dient, diente, hat gedient	служить
die Gelegenheit, -en	случай
der Zufall, ¨-e	случай
zufällig	случайный
geschehen, geschieht, geschah, ist geschehen	случаться
passieren, passiert, passierte, ist passiert	случаться
der Hörer, -; die Hörerin, -nen der Zuhörer	слушатель
der Zuhörer, - die Zuhörerin, -nen	слушатель
zuhören, hört zu, hörte zu, hat zugehört	слушать
hören, hört, hörte, hat gehört	слышать
1 cm = ein Zentimeter	см
das Smartphone, -s	смартфон
tödlich	смертельный
der Tod	смерть
lachen, lacht, lachte, hat gelacht	смеяться
das Pech	смола
ansehen, sieht an, sah an, hat angesehen	смотреть
sehen, sieht, sah, hat gesehen	смотреть
zuschauen, schaut zu, schaute zu, hat zugeschaut	смотреть
nachschlagen, schlägt nach, schlug nach, hat nachgeschlagen	смотреть информацию гделибо
fernsehen, sieht fern, sah fern, hat ferngesehen	смотреть телевизор [телепередачу]
je nachdem…	смотря по
Textnachricht	смс
außen	снаружи
draußen	снаружи
anfangs	сначала
erst	сначала
zuerst	сначала
zunächst	сначала
der Schnee	снег
der Imbiss, -e (D) → A: Jause, CH: Znüni/Zvieri	снек
die Ermäßigung, -en	снижение
abhängen, hängt ab, hing ab, hat abgehangen (von)	снимать
abheben, hebt ab, hob ab, hat abgehoben	снимать
mieten, mietet, mietete, hat gemietet	снимать
der Hund, -e	собака
das Vorstellungsgespräch, -e	собеседование
sammeln, sammelt, sammelte, hat gesammelt	собирать
die Versammlung, -en	собрание
eigen-	собственный
das Ereignis, -se	событие
das Gewissen	совесть
der Rat	совет
Ratschlag, ¨-e	совет
beraten, berät, beriet, hat beraten	советовать
die Zusammenarbeit	совместная работа
modern	современный
die Zustimmung, -en	согласие
einverstanden	соглашаться
zustimmen, stimmt zu, stimmte zu, hat zugestimmt	соглашаться
das Gehalt, ¨-er	содержание
der Inhalt, -e	содержание
die Unterhaltung, -en	содержание
enthalten, enthält, enthielt, hat enthalten	содержать
zusammenfassen, fasst zusammen, fasste zusammen, hat zusammengefasst	соединять
schaffen, schafft, schaffte, hat geschafft	создавать
der Saft, ¨-e	сок
reduzieren, reduziert, reduzierte, hat reduziert	сокращать
sonnig	солнечный
die Sonne, -n	солнце
das Salz, -e	соль
zweifeln, zweifelt, zweifelte, hat gezweifelt	сомневаться
der Zweifel, -	сомнение
der Schlaf	сон
der Traum, ¨-e	сон
anmelden, meldet an, meldete an, hat angemeldet	сообщать
berichten, berichtet, berichtete, hat berichtet	сообщать
melden, meldet, meldete, hat gemeldet	сообщать
mitteilen, teilt mit, teilte mit, hat mitgeteilt	сообщать
die Anzeige, -n	сообщение
die Anmeldung, -en	сообщение
die Angabe,-n	сообщение
die Anzeige, -n	сообщение
Bescheid sagen	сообщить комул
nach Gebühr	соответствующим образом
das Verhältnis, -se	соотношение
der Nachbar, -n die Nachbarin, nen	сосед
sich konzentrieren	сосредотачиваться
der Zustand, ¨-e	состояние
stattfinden, findet statt, fand statt, hat stattgefunden	состояться
der Mitarbeiter, - die Mitarbeiterin, -nen	сотрудник
die Soße/Sauce, -n	соус
sozial	социальный
der Sozialarbeiter, - die Sozialarbeiterin, -nen	социальный работник
der Bund, Bundes	союз
der Verein, -e	союз
retten, rettet, rettete, hat gerettet	спасать
danke	спасибо
schlafen, schläft, schlief, hat geschlafen	спать
der Fachmann die Fachfrau, -en	специалист
der Spezialist, -en die Spezialistin, -nen	специалист
die Fachleute (Pl.)	специалисты
die Sonderschule, -n	специальная школа
die (Fach-)Hochschule, -n	специальное высшее учебное заведение
Sonder- das Sonderangebot, -e	специальное предложение
Spezial-	специальный
eilen, eilt, eilte, hat/ist geeilt	спешить
der Rücken, -	спина
der Alkohol, -s, -e	спирт
die Liste, -n	список
das Streichholz, ¨-er → Zündholz; A: Zünder	спичка
die Zünder (A) (Pl.) → Streichholz; Zündholz	спички
einig	сплоченый
cool	спокойный
ruhig	спокойный
die Ruhe	спокойствие
der Streit	спор
(sich) streiten, streitet, stritt, hat gestritten	спорить
die Sport, -(e)s, -e	спорт
der Sport	спорт
sportlich	спортивный
der Sportler, - die Sportlerin, -nen	спортсмен
der Profisportler, - die Profisportlerin, -nen	спортсменпрофессионал
die Art, -en	способ
die Fähigkeit, -en	способность
fördern, fördert, förderte, hat gefördert	способствовать
rechts	справа
gerecht	справедливый
der Bescheid, -e	справка
sich erkundigen, erkundigt sich, erkundigte sich, hat sich erkundigt	справляться
zurechtkommen, kommt zurecht, kam zurecht, ist zurechtgekommen	справляться самостоятельно
fragen, fragt, fragte, hat gefragt (nach D, wegen G, um A)	спрашивать о комлибо
vgl.	ср сравни
der Vergleich, -e	сравнение
vergleichen, vergleicht, verglich, hat verglichen	сравнивать
kämpfen, kämpft, kämpfte, hat gekämpft	сражаться
der Mittwoch, -(e)s, -e, mittwochs, am Mittwoch	среда
die Umwelt	среда обитания
durchschnittlich	средний
die Medien (Pl.)	средства массовой информации
das Mittel, -	средство
die Frist, -en	срок
der Termin, -e	срок
dringend	срочный
einstellen, stellt ein, stellte ein, hat eingestellt	ставить
stellen, stellt, stellte, hat gestellt	ставить
(sich) vorstellen, stellt vor, stellte vor, hat vorgestellt	ставить вперед
parken, parkt, parkte, hat geparkt (D, A) → CH: parkieren	ставить на стоянку
das Stadion, Stadien	стадион
werden, wird, wurde, ist geworden	становиться
pensioniert werden/sein (D, CH) → D, A: in Pension gehen/sein; D: in Rente gehen/sein	становиться пенсионером
die Station, -en	станция
sich bemühen, bemüht, bemühte, hat bemüht	стараться
der Start, -s	старт
starten, startet, startete, ist gestartet	стартовать
die Senioren (Pl.)	старший
alt	старый
die Statistik, -en	статистика
statistisch	статистический
der Artikel, -	статья
das Steak, -s	стейк
die Mauer, -n	стена
die Wand, ¨-e	стена
stilistisch	стилистический
der Stil, -e	стиль
(sich) waschen, wäscht, wusch, hat gewaschen	стирать
das Gedicht, -e	стихотворение
der Wert, -e	стоимость
gelten, gilt, galt, hat gegolten	стоить
kosten, kostet, kostete, hat gekostet	стоить
die Mobilbox, -en	стойло
der Tisch, -e	стол
die Hauptstadt, ¨-e	столица
die Kantine, -n	столовая
soviel	столько
die Seite, -n	сторона
der Himmelsrichtungen	стороны света
stehen, steht, stand, hat/ist gestanden	стоять
leiden, leidet, litt, hat gelitten	страдать
seltsam	странный
die Sucht, ¨-e	страсть
die Angst, “-e	страх
der Schreck(en)	страх
die e-card (A) → D: die Versichertenkarte	страховая карта
furchtbar	страшный
schrecklich	страшный
unheimlich	страшный
schießen, schießt, schoss, hat geschossen	стрелять
der Stress	стресс
streng	строгий
die Baustelle, -n	строительная площадка
der Bau, Bauten	строительство
bauen, baut, baute, hat gebaut	строить
erstellen, erstellt, erstellte, hat erstellt	строить
schlank	стройный
die Zeile, -n	строка
die Struktur, -en E	структура
der Textaufbau	структура
der Student, -en die Studentin, -nen	студент
der Studierende, -n die Studierende, -n	студент
die Mensa, -s/-en	студенческая столовая
der Sessel, - (A) → D, CH: Stuhl	стул
der Stuhl, ¨-e	стул
auftreten, tritt auf, trat auf, ist aufgetreten	ступать
die Stufe, -n	ступень
der Steward, -s die Stewardess, -en	стюард
der Samstag; D: der Sonnabend samstags; D: sonnabends, am Samstag	суббота
das Souvenir, -s	сувенир
das Gericht, -e	суд
der Richter, - die Richterin, -nen	судья
der Betrag, ¨-e	сумма
die Summe, -n	сумма
der Laden, ¨-	сундук
die Suppe, -n	суп
der Supermarkt, ¨-e	супермаркет
die Ehefrau, -en/der Ehemann, ¨-er	супруг
das Ehepaar, -e	супруги
trocken	сухой
trocknen, trocknet, trocknete, hat/ist getrocknet	сушить
bestehen, besteht, bestand, hat bestanden	существовать
die Bühne, -n	сцена
die Szene, -n	сцена
glücklich	счастливый
das Glück	счастье
das Konto, Konten	счет
zählen, zählt, zählte, hat gezählt	считать
(herunter-)fahren, fährt herunter, fuhr herunter, hat heruntergefahren	съезжать
der Mieter, - die Mieterin, -nen	съемщик
der Sohn, ¨-e	сын
der Käse	сыр
feucht	сырой
roh	сырой
satt	сытый
das/der Sandwich, -(e)s/-e	сэндвич
her/her	сюда
herein-, rein	сюда
hierher	сюда
das Zeugnis, -se	табель
die Tablette, -n	таблетка
die Tabelle, -n	таблица
das Geheimnis, -se	тайна
geheim	тайный
heimlich	тайный
so	так
ebenso	так же
denn	так как
so viel/so viel wie	так много
sogenannt	так называемый
sodass	так что
ebenfalls	также
mit	также
solch	такой
das Taxi, -s	такси
das Talent, -e	талант
dort	там
drüben	там
drin, drinnen	там внутри
der Tanz, ¨-e	танец
tanzen, tanzt, tanzte, hat getanzt	танцевать
der Teller, -	тарелка
fest	твердый
hart	твердый
das Theater, -	театр
der Text, -e	текст
das Fernsehen	телевидение
das TV, -	телевизор
Fernsehgerät <-(e)s, -e>	телевизор
der Fernseher, -	телезритель
körperlich	телесный
das Telefon, -e	телефон
der Körper, -	тело
indem	тем что
das Thema, Themen	тема
dunkel	темный
dunkel	темный
das Tempo	темп
die Temperatur, -en	температура
das Tennis	теннис
theoretisch	теоретический
die Theorie, -n	теория
jetzt	теперь
nun	теперь
die Wärme	тепло
warm	теплый
die Therapie, -n	терапия
die Geduld	терпение
sich etwas gefallen lassen, lässt sich etwas gefallen, ließ sich etwas gefallen, hat sich etwas gefallen lassen sich (D) etw. (A)	терпеть чтол
tolerant	терпимый
die Terrasse, -n	терраса
eng	тесный
knapp	тесный
der Test, -s	тест
das Heft, -e	тетрадь
die Tante, -n	тетя
die Technik, -en	техника
technisch	технический
die Technologie, -n	технология
fließen, fließt, floss, ist geflossen	течь
der Typ, -en	тип
typisch	типичный
leise	тихий
still	тихий
der Stoff, -e	ткань
die Ware, -n	товар
damals	тогда
dann	тогда
auch	тоже
gleichfalls	тоже
schieben, schiebt, schob, hat geschoben	толкать
(sich) stoßen, stößt, stieß, hat gestoßen	толкать
dick	толстый
ausschließlich	только
irgend irgendein	только
nur	только
vorhin	только что
der Paradeiser, - (A) → Tomate	томат
die Tomate, -n → A: Paradeiser	томат
dünn	тонкий
heizen, heizt, heizte, hat geheizt	топить
der Handel	торговля
bremsen, bremst, bremste, hat gebremst	тормозить
sich beeilen, beeilt sich, beeilte sich, hat sich beeilt	торопиться
die Torte, -n	торт
das Heimweh	тоска по родине
derselbe, dieselbe, dasselbe	тот же
total	тотальный
der Punkt, -e	точка
der Punkt, -e	точка
genauso	точно такой же
genau	точный
das Gras	трава
die Verletzung, -en	травма
traditionell	традиционный
die Tradition, -en	традиция
der Wirt, -e die Wirtin, -nen	трактирщик
die Straßenbahn, -en	трамвай
die Straßenbahn, -en (D, A) → CH: Tram	трамвай
das Tram, -s → D, A: Straßenbahn	трамвай
das Verkehrsmittel, -	транспорт
der Transport, -e	транспортирование
transportieren, transportiert, transportierte, hat transportiert	транспортировать
das Fahrzeug, -e	транспортное средство
das Kraftfahrzeug, -e	транспортное средство
die Forderung, -en (auf А, nach D)	требование чеголибо
erfordern, erfordert, erforderte, hat erfordert	требовать
fordern, fordert, forderte, hat gefordert	требовать
verlangen, verlangt, verlangte, hat verlangt	требовать
erforderlich	требуемый
der Trend, -s	тренд
der Trainer, - die Trainerin, -nen	тренер
trainieren, trainiert, trainierte, hat trainiert	тренировать
das Training, -s	тренировка
die Übung, -en	тренировка
dritte	третий
⅓ = ein Drittel, drittel ...	треть
das Pfingsten	Троица
der Gehsteig (D, A) → CH: Trottoir	тротуар
das Trottoir, -s (CH) → Gehsteig (D, A)	тротуар
die Schwierigkeit, -en	трудность
schwierig	трудный
schütteln, schüttelt, schüttelte, hat geschüttelt	трясти
das WC, -s	туалет
die Toilette, -n	туалет
dahin	туда
dorthin	туда
der Nebel, -	туман
neblig	туманный
die Tour, -en	тур
das Reisebüro, -s	турагентство
der Tourismus	туризм
der Tourist, -en die Touristin, -nen	турист
die Rundfahrt, -en	турне
die Türkei der Türke, -n die Türkin, -nen türkisch Türkisch	Турция турок
hier/hier-	тут
das Jahrtausend, -e	тысячелетие
das Gefängnis, -se	тюрьма
schwer	тяжелый
an	у
bei	у
fliehen, flieht, floh, ist geflohen	убегать
(sich) überzeugen, überzeugt, überzeugte, hat überzeugt	убеждать
die Überzeugung, -en	убеждение
das Asyl	убежище
der Killer, -/die Killerin, -nen	убийца
aufräumen, räumt auf, räumte auf, hat aufgeräumt	убирать
der Nachteil, -e	убыток
achten, achtet, achtete, hat geachtet (auf)	уважать
geehrt	уважать
Achtung!	уважение
der Respekt	уважение
vergrößern, vergrößert, vergrößerte, hat vergrößert	увеличивать
zunehmen, nimmt zu, nahm zu, hat zugenommen	увеличиваться
die Versicherung, -en	уверение
versichern, versichert, versicherte, hat versichert	уверять
spannend	увлекательный
überreden, überredet, überredete, hat überredet	уговорить
die Ecke, -n (D, CH) → A: Eck	угол
das Eck, -en (A) → D, CH: Ecke	угол
strafbar	уголовно наказуемый
Kriminal die Kriminalpolizei	уголовный уголовный розыск
gelingen, gelingt, gelang, ist gelungen	удаваться
entfernen, entfernt, entfernte, hat entfernt	удалять
abnehmen, nimmt ab, nahm ab, hat abgenommen	удалять снимать
festhalten, hält fest, hielt fest, hat festgehalten	удерживать
überraschen, überrascht, überraschte, hat überrascht	удивлять
sich wundern, wundert sich, wunderte sich, hat sich gewundert	удивлять удивляться
verlängern, verlängert, verlängerte, hat verlängert	удлинять
bequem	удобный
befriedigend	удовлетворительный
der Spaß	удовольствие
das Vergnügen, -	удовольствие
der Ausweis, -e	удостоверение личности
verreisen, verreist, verreiste, ist verreist	уезжать
halt	уж
bereits	уже
schon	уже
schmal	узкий
erfahren, erfährt, erfuhr, hat erfahren	узнавать
die Anweisungssprache, -en	указание
die Gebrauchsanweisung, -en	указание
der Hinweise, -e	указание
hinweisen, weist hin, wies hin, hat hingewiesen (auf A)	указывать
einpacken, packt ein, packte ein, hat eingepackt	укладывать
packen, packt, packte, hat gepackt	укладывать
die Ukraine der Ukrainer - die Ukrainerin, -nen ukrainisch Ukrainisch	Украина украинец
der Schmuck	украшение
der Essig	уксус
die Straße, -n	улица
die Einbahnstraße, -n	улица с односторонним движением
(sich) verbessern, verbessert, verbesserte, hat verbessert	улучшать
die Besserung	улучшение
lächeln, lächelt, lächelte, hat gelächelt	улыбаться
die Intelligenz	ум
sterben, stirbt, starb, ist gestorben	умирать
intelligent	умный
klug	умный
die Universität (Uni), -en	университет
die Universität, -en	университет
die Uniform, -en	униформа
verpacken, verpackt, verpackte, hat verpackt	упаковывать
zuordnen	упорядочить
die Verwaltung, -en	управление
üben	упражняться
der Vorwurf, ¨-e	упрек
versäumen, versäumt, versäumte, hat versäumt	упустить
die Ernte, -n	урожай
die Mühe	усилие
der Intensivkurs, -e	ускоренный курс
die Bedingung, -en	условие
verabredet	условный знак
der Erfolg, -e	успех
der Fortschritt, -e	успех
erfolgreich	успешный
beruhigen, beruhigt, beruhigte, hat beruhigt	успокаивать
müde	усталый
festlegen, legt fest, legte fest, hat festgelegt	устанавливать
feststellen, stellt fest, stellte fest, hat festgestellt	устанавливать
installieren, installiert, installierte, hat installiert	устанавливать
die Anlage, -n	установка
mündlich	устный
(sich) verabschieden, verabschiedet, verabschiedete, hat verabschiedet	устраивать проводы
die Einrichtung, -en	устройство
behaupten, behauptet, behauptete, hat behauptet	утверждать
entsorgen, entsorgt, entsorgte, hat entsorgt	утилизировать
die Ente, -n	утка
anstrengend	утомительный
der Morgen, -	утро
morgens, am Morgen	утром
pflegen, pflegt, pflegte, hat gepflegt	ухаживать
das Ohr, -en	ухо
die Betreuung	уход
in Pension gehen/sein (D, A) → D: in Rente gehen/ sein; D, CH: pensioniert werden/sein	уходить на пенсию
verlassen, verlässt, verließ, hat verlassen	уходить уезжать
sich beteiligen, beteiligt sich, beteiligte sich, hat sich beteiligt	участвовать
teilnehmen, nimmt teil, nahm teil, hat teilgenommen	участвовать
die Teilnahme, -n	участие
der Teilnehmer, - die Teilnehmerin, -nen	участник
das Studium, Studien	учеба
die Bildungseinrichtung, -en	учебное заведение
der Azubi, -s (D)	ученик
der Lehrling, -e	ученик
der Lerner, - die Lernerin, -nen	ученик
der Schüler, - die Schülerin, -nen	ученик
der Wissenschaftler, - die Wissenschaftlerin, -nen	ученый
der Lehrer, - die Lehrerin, -nen	учитель
lernen, lernt, lernte, hat gelernt	учиться
gemütlich	уютный
die Fabrik, -en	фабрика
die Datei, -en	файл
das Fax, -e	факс
die Tatsache, -n	факт
tatsächlich	фактический
der Faktor, -en	фактор
falsch	фальшивый
der Familienname, -n	фамилия
die Fantasie/Phantasie, -n	фантазия
die Phantasie/Fantasie, -n	фантазия
fantastisch	фантастический
der Februar	февраль
das Bundesland, -(e)s	федеральная земля
der Bundeskanzler, - die Bundeskanzlerin, -nen	федеральный канцлер в ФРГ
der Bundespräsident, - die Bundespräsidentin, -nen	федеральный президент
die Bundesrepublik Deutschland	Федеративная Республика Германия
das Festival, -s	фестиваль
die Figur, -en	фигура
die Physik	физика
die Philosophie, -ien	философия
finanzieren, finanziert, finanzierte, hat finanziert	финансировать
finanziell	финансовый
violett	фиолетовый
die Firma, Firmen	фирма
die Flöte, -n	флейта
die Diskothek, -en/Disko, -s	фонотека
die Form, -en	форма
das Formular, -e	формуляр
das Forum, Foren (Internetforum)	форум
der Fotoapparat, -e	фотоаппарат
der Fotograf, -en	фотограф
fotografieren, fotografiert, fotografierte, hat fotografiert	фотографировать
das Foto, -s	фотография
die Fotografie, -n	фотография
1 sFr. = 1 Franken, -	франк
das Obst (D, A) → CH: Früchte	фрукты
funktionieren, funktioniert, funktionierte, hat funktioniert	функционировать
der Fußball, ¨-e	футбол
das T-Shirt, -s	футболка
loben, lobt, lobte, hat gelobt	хвалить
fassen, fasst, fasste, hat gefasst	хватать
genügen, genügt, genügte, hat genügt	хватать
greifen, greift, griff, hat gegriffen (nach D, an A)	хватать
die Hütte, -n	хижина
die Chemie	химия
der Hit, -s	хит
das Brot, -e	хлеб
klopfen, klopft, klopfte, hat geklopft	хлопать
das Hobby, -s	хобби
umgehen, geht um, ging um, ist umgegangen	ходить
spazieren gehen, geht spazieren, ging spazieren, ist spazieren gegangen	ходить гулять
der Kühlschrank, ¨-e	холодильник
kalt	холодный
ledig	холостой
die Fitness, -	хорошая физическая [спортивная] форма
o.k./O.K./okay	хорошо
gut	хорошо
wohl	хорошо
fit	хорошо тренированный
die Jugendherberge, -n	хостел
wollen, will, wollte, hat gewollt (hat wollen als Modalverb)	хотеть
obwohl	хотя
speichern, speichert, speicherte, hat gespeichert	хранить на складе
der Künstler, - die Künstlerin, -nen	художник
der Maler, - die Malerin, -nen	художник
mager	худой
blühen, blüht, blühte, hat geblüht	цвести
die Farbe, -n	цвет
die Farbe, -n	цвет
die Blume, -n	цветок
küssen, küsst, küsste, hat geküsst sich küssen	целовать
das Ziel, -e	цель
der Zweck, -e	цель
der Preis, -e	цена
wertvoll	ценный
1 c = 1 Cent	цент
das Zentrum, Zentren	центр
zentral	центральный
der Hauptbahnhof, ¨-e	центральный вокзал
die Kette, -n	цепочка
die Kirche, -n	церковь
der Zirkus, -se	цирк
digital	цифровой
das Poulet, -s (CH) → D: Hähnchen/Hühnchen; A: Hend(e)l	цыпленокбройлер
das Trinkgeld, -er	чаевые
der Tee	чай
die Kanne, -n	чайник
die Stunde, -n stündlich	час
die Stunde, -n	час
privat	частный
oft/öfter	часто
häufig	частый
der Abschnitt, -e	часть
die Teil, -e	часть
die Uhr, -, -en	часы
die Uhr, -en	часы
der Chat(room), -s	чат
die Tasse, -n	чашка
meist-, die meisten	чаще всего
meist(ens)	чаще всего
der Mensch, -en	человек
menschlich	человеческий
je eher, desto besser	чем раньше
je … desto …	чем тем
der Koffer, -	чемодан
durch	через
die Schildkröte, -n	черепаха
schwarz	черный
ehrlich	честный
der Donnerstag, donnerstags, am Donnerstag	четверг
vierte	четвертый
das Viertel, - (D, A) → CH: Quartier	четверть
gerade	четный
reparieren, repariert, reparierte, hat repariert	чинить
die Chipkarte, -n	чипкарта
der Chip, -s	чипсы 
die Zahl, -en	число
die Anzahl, -en	число
putzen, putzt, putzte, hat geputzt	чистить
reinigen, reinigt, reinigte, hat gereinigt	чистить
staubsaugen, staubsaugt, staubsaugte, hat gestaubsaugt	чистить пылесосом
die Reinigung, -en	чистка
rein	чистый
sauber	чистый
der Leser, - die Leserin, -nen	читатель
lesen, liest, las, hat gelesen	читать
das Mitglied, -er	член семьи
dass	что
was	что
um … zu	чтобы
etwas	чтолибо
das Gefühl, -e	чувство
der Sinn	чувство
fühlen, fühlt, fühlte, hat gefühlt	чувствовать
spüren, spürt, spürte, hat gespürt	чувствовать
wunderbar	чудесный
das Wunder, -	чудо
der Strumpf, ¨-e	чулок
der Schritt, -e	шаг
die Chance, -n	шанс
der Kugelschreiber, -	шариковая ручка
der Kuli, -s	шариковая ручка кули
locker	шаткий
die Schweiz der Schweizer, - die Schweizerin, -nen Schweizer, schweizerisch	Швейцария швейцарец швейцарский язык
wollen	шерстяной
der Aufzug, ¨-e (D, A) → Lift	шествие
der Chef, -s die Chefin, -nen	шеф
der Hals, ¨-e	шея
chic/schick	шикарный
der Reifen, -	шина
die Breite, -n	ширина
breit	широкий
nähen, näht, nähte, hat genäht	шить
die Kassette, -n	шкатулка
der Schrank, ¨-e (D, CH) → A, CH: Kasten	шкаф
die Schule, -n	школа
das Schulfächer, -(e)s	школьный предмет
der Hut, ¨-e	шляпа
das Schnitzel, -	шницель обрывок
die Schokolade, -n	шоколад
die Show, -s	шоу
der Stift, -e	штифт
der Strafzettel, -	штрафная квитанция
der Lärm	шум
der Witz, -e	шутка
klicken, klickt, klickte, hat geklickt	щелкнуть
die Bürste, -n	щётка
die Zange, -n	щипцы
das Schild, -er	щит
hallo	эй! ау! алло! привет! вот это да!
das Abitur (D)→A, CH: Matura	экзамен на аттестат зрелости
Öko- (ökologisch)	экологичный
die Wirtschaft	экономика
der Bildschirm, -e	экран
der Experte, -n	эксперт
der Export, -e	экспорт
der Notruf	экстренный вызов
elegant	элегантный
elektrisch	электрический
das E-Bike, -s	электровелосипед
das E-Book, -s	электронная книга
elektronisch	электронный
die (D, A)/das (A, CH) (E-)Mail, -s	электронный адрес
die Mailbox, -en	электронный почтовый ящик
das Kraftwerk, -e	электростанция
die Energie, -n	энергия
das Lexikon, -Lexika	энциклопедия
die Studie, -n	эскиз
die Etage, -n (D, CH) → Stock	этаж
der Stock → D, CH: Etage	этаж
das Stockwerk, -e	этаж
es	это
das heißt	это значит
dies- diesmal	это на этот раз
der Rock, ¨-e	юбка пиджак
der Süden, Süd-/südlich	юг
der Humor	юмор
der Apfel, ¨-	яблоко
das Gift, -e	яд
giftig	ядовитый
die Sprache, -n	язык
die Zweitsprache, -n	язык
das Ei, -er	яйцо
der Januar, -(s), -e	январь
wütend	яростный
die Krippe/der Kindergarten/die Kindertagesstätte (Kita)	ясли
deutlich	ясный
eindeutig	ясный
klar	ясный
der Kasten, ¨- (D) → Kiste (A, D) der Kasten, ¨- (A, CH) → D, CH: Schrank	ящик
die Kiste, -n (A, D) → D: Kasten	ящик