der Abend, -e	вечер
der Abendkurs, -e	вечерний курс
abends	вечерами
aber	но
der Abschied, -e	прощание
der Abschnitt, -e	отрезок
acht	8
der Actionfilm, -e	боевик
die Adresse, -n	адрес
afrikanisch	африканский
der Akkusativ	Винит.падеж
die Aktivität, -en	занятние
alle	все
alleine	сам
alt	старый
das Alter (nur Sing.)	возраст
am Abend	вечером
am Dienstag	во вторник
am Mittag	днем
am Montag	в понедельник
am Morgen	утром
am Nachmittag	в послеобеденное время
am Vormittag	в дообеденное время
anfangen	начинать
die Angabe, -n	сведения
ankreuzen	отметить крестиком
die Anmeldung, -en	регистрация
der Anruf, -e	оклик
anrufen	окликать
die Ansage, -n	объявление
ansehen	(по)смотреть
die Antwort, -en	ответ
antworten	отвечать
die Anzeige, -n	объявление
das Apartment, -s	комфортабелъная квартирка
der Apfel	яблоко
der Apfelkuchen,	яблочный пирог
der Apfelsaft, -..e	яблочный сок
das Arabisch (nur Sing.)	арабский
arbeiten	работать
das Arbeitsamt, -..er	ведомство по труду (трудоусторйство)
der Artikel,	артикль
der Arzt, -..e	врач
die Arztpraxis, -en	врачебная практика
der Atlas,se	атлас
auch	тоже
auf Deutsch	по-немецки
auf Wiederhören	До свидания (говорят по телефону)
auf Wiedersehen	До свидания
aufräumen	убирать
aufstehen	вставать
ausfüllen	заполнять
die Aussage, -n	высказывание
abfahren	отъезжать
die Abfahrt (Sing.)	отъезд
abfliegen	вылетать
der Abflug., -..e	вылет
abgeben	сдавать
abholen	встречать (забиратъ что-либо/кого-либо откуда-то)
die Absage, -n	отказ
der Absender,	отправитель
achten	следить за
der Adressat, -en	адресат
der Alkohol (Sing.)	алкоголь
das Alphabet, -e	алфавит
ambulant	амбулаторный
die Ampel, -n	светофор
das Amt, -..er	ведомство
anbei	в приложении
anbieten	предлагать
anders	другой
das Angebot, -e	предложение
die/der Angehörige, -n (ein Angehöriger)	родственник
ankommen	прибывать
die Ankunft (Sing.)	прибытие
anmachen	включать
anmelden	регистировать/заявлять
anprobieren	(по)мерить
die Anrede (Sing.)	обращение
der Anrufbeantworter,	тел.автоответчик
der Anrufer,	звонящий
anschließend	затем/сразу/после
der Anschluss, -..e	удобная пересадка
anstehen	стоять в очереди
der Antrag, -..e	заявление
der Antwortbogen,	лист для ответа
die Anweisung, -en	указание
anziehen	надевать
die Apotheke, -n	аптека
der April	апрель
die Arbeit, -en	работа
der Arbeiter,	работник
der Arbeitgeber,	работодатель
das Arbeitsblatt, -..er	рабочий лист
arbeitslos	безработный
der Arbeitsplatz, -..e	рабочее место
die Arbeitszeit, -en	рабочее время
der Arm, -e	рука
die Arzttermin, -e	назначение времени у врача
das Aspirin (Sing)	аспирин
die Aufforderung, -en	требование
auffüllen	наполнить доверху
die Aufgabe, -n	задание
aufmachen	открыть
aufpassen	быть внимателъным
aufschreiben	прописать
das Auge, -n	глаз
die Augenfarbe	цвет глаз
der August	август
der Ausgang, -..e	выход
die Auskunft, -..e	справка/инфо
der Ausländer,	иностранец
die Ausleihe, -n	выдача
ausmachen	выключать
aussehen	выглядить
außerdem	кроме того
aussteigen	выходить
auswählen	выбирать
der Ausweis, -e	удостоверение
das Auto, -s	автомобиль
die Autobahn, -en	скоростная автонагистраль
das Autofahren	автовождение
der Automechaniker,	автомеханик
die Autovermietung, -en	прокат машин
die Autowerkstatt, -..en	автомастерская
das Baby, -s	младенец
die Bäckerei, -n	булочная
das Bad, -..r	ванная
die Badewanne, -n	ванна
das Badezimmer,	ванная комната
der Bahnhof, -..e	вокзал
der Balkon, -e	балкон
die Banane, -n	банан
der Becher,	кружка
das Bedauern (nur Sing.)	сожаление
bedeuten	означать
das Befinden (nur Sing,)	самочувствие
die Begrüßung, -en	приветствие
das Beispiel, -e	пример
bequem	удобный
beschreiben	описывать
besondere	особенные
besser	лучше
bestimmt	определенно
das Bett, -en	кровать
bewölkt	облачно
bezahlen	платить
das Bier, -e	пиво
das Bild, -er	картина
bilden	составлять
billig	дешевый
bitte	пожалуйста
bitten	просить
boxen	заниматься боксом
brauchen	нуждатъся в...
braun	коричневый
die Breite (nur Sing)	широта
der Brief, -e	письмо
der Brieffreund, -e	друг по переписке
der Briefumschlag, -..e	конверт
bringen	приносить
das Brot, -e	хлеб
das Brötchen,	булочка
das Buch,-..er	книга
der Buchstabe, -n	буква
buchstabieren	говоритъ по буквам
der Bus, -se	автобус
die Butter (nur Sing)	масло
die Baby-Wäsche (Sing.)	детское белье
baden	купать
der Bahnsteig, -e	платформа
bald	скоро
das Band, -..er	том
die Bank, -en	банк
die Bauarbeiten (Plural)	строительные работы
der Bauarbeiter,	строитель
der Bauch, -..e	живот
der Baum, -..e	дерево
der Beamte, -n	чиновник
bearbeiten	обработать
der Beginn (Sing.)	начало
beginnen	начинать
begrenzt	ограниченный
die Behörde, -n	учреждение
das Bein, -e	нога
bekommen	получать
die Bemerkung, -en	примечание
benutzen	использовать
der Berg, -e	гора
der Beruf, -e	профессия
berufstätig	работающий
die Beschwerde, -n	жалоба
besetzt	занятый
besonders	особенно
bestellen	заказывать
bestimmen	определять
der Besuch, -e	визит
besuchen	посещать
die Betonung, -en	ударение
bewegen	двигать (ся)
die Bitte, -n	просьба
das Blei (Sing.)	свинец
bleiben	оставаться
das Bleigießen	гадание на растопленом свинце
die Blume, -n	цветок
der Blumenstrauß, -..e	букетов цветов
die Bluse, -n	блузка
brechen	ломать
die Briefmarke, -n	почтовая марка
die Brille, -n	очки
die Brücke, -n	мост
die Buchstabenkette, -n	цепочка букв
das Bundesland, -..er	федеральная земля
das Büro, -s	бюро
der Busfahrer,	водитель автобуса
der Busführerschein, -e	права на вождение автобуса
das Cafe, -s	кафе
der Cent, -s	цент
die Chiffre, -n	шифр
der Club, -s	клуб
die Cola (Sing.)	кола
der Computer,	компьютер
der Computertisch, -e	компьютерный стол
die CD, -s	CD
der Champagner (Sing)	шампанское
der Chef, -s	шеф
die Chefin, -nen	шефиня
die Chip-karte, -n	электронная карта (сим-карта)
der Clown, -s	клоун
der Computerspezialist, -e	компьютерный специалист
dabeihaben	иметь с собой
die Dame, -en	дама
danach	после
danke	спасибо
danken	благодарить
denn	тогда
das Datum, die Daten	дата
der Deutschkurs	курс немецкого
Deutschland (Sing.)	Германия
deutschsprachig	немецкоговорящий(ая)
der Deutschunterricht, -e	занятие (урок) по немецкому
der Dialog, -e	диалог
das Diktat, -e	диктант
der Dienstag, -e	вторник
diktieren	диктовать
der Donnerstag, -e	четверг
die Dose, -n	консервная банка.
dunkel	темный
der Durst (nur Sing.)	жажда
die Dusche, -n	душ
der Dativ, -e	дательный падеж
das Datum (Sing)	дата
dauern	длиться
denken	думать
deshalb	поэтому
die Detailansicht, -en	подробное описание
der Deutschtest, -s	тест по немецкому
der Dezember	декабрь
dick	толстый
das Diplom	диплом
direkt	прямой
die Disko, -s	дискотека
der Doktor, -en	доктор
das Dokument, -e	документ
das Dorf, -..er	деревня
dreimal	трижды
dringend	срочно
die Drogerie, -n	магазин аптекарских и косметических товаров
drüben	внутри
drücken	нажимать
der Drucker,	принтер
das Ei, -er	яйцо
einige	несколько
der Einkauf, -..e	покупка
der Einkaufswagen,..en	тележка для покупок
einkaufen	покупать
die Einladung, -en	приглашение
einmal	один раз
das Elektrogerät, -e	электроприбор
die Eltern (Plural)	родители
die E-Mail, s	электронный адрес
das Ende, -n	конец
endlich	наконец
die Englischkurs, -e	курс английского
Entschuldigen Sie!	Извините
die Entschuldigung, -en	извинение
ergänzen	дополнять
erklären	объяснить
erreichen	достигать
erzählen	рассказывать
essen	естъ (кушать)
der Esstisch, -e	обеденный стол
der Euro, -s	евро
das Europa (nur Sing.)	Европа
die Exkursion, -en	экскурсия
ebenso	также
echt	настоящий
die Ecke, -n	угол
die Ehefrau, -en	жена
das Ehepaar, -e	супружеская пара
der Ehering, -e	обручальное колъцо
eilig	спешный
einfach	простой
der Eingang, -..e	вход
einladen	приглашать
einordnen	подобрать
einsteigen	вставлять
einsetzen	садитъся (в транспорт)
eintragen	вносить
einzeln	отдельный
einziehen	въезжатъ (в квартиру)
das Einzugsdatum (Sing)	дата възда (в квартиру)
der Empfänger,	получатель
eng	узкий
das Englisch	английский язык
entschuldigen	извинять
das Erdgeschoss, -e	нижний этаж
erforderlich	необходимо
erhalten	получать
die Erklärung, -en	объяснение
erlaubt	разрешенный
das Erlebnis, -se	переживание
erledigen	сделать
ersetzen	заменить
erst	только
die/der Erwachsene, -n (ein Erwachsener)	взрослый (ая)
das Essen (Sing)	еда
exquisit	превосходный
fahren	ехать
das Fahrrad, -er	велосипед
falsch	неправильный
die Familie, -n	семья
das Familienfoto, -s	семейное фото
der Familienname, -n	фамилия
der Familienstand (nur Sing.)	семейное положение
die Farbe, -n	цвет
feminin	женский род
der Fernseher,	телевизор
das Fernsehprogramm, -e	телепрограмма
der Fernsehtisch, -e	столик для ТВ
fertig	готовый
das Fieber (nur Sing.)	высокая температура
der Film, -e	фильм
finden	находить
die Firma, die Firmen	фирма
der Fisch, -e	рыба
das Fitness-Studio, -s	фитнесс-студия
die Flasche, -n	бутылка
das Fleisch (nur Sing.)	мясо
der Flur, -e	коридор
der Fluss, -..e	река
die Folge, -n	серия
folgende	следующий
die Form, -en	форма
das Formular, -e	формуляр
das Foto, -s	фото
die Frage, -n	вопрос
der Französischkurs, -e	курс французского
die Frau, -en	женщина
(der) Freitag, -e	пятница
die Freizeit, -en	свободное время
der Freund, -e	друг
freundlich	дружеский
freuen	радовать
die Freundin, -nen	подруга
der Friseursalon, -e	парикмахерская
früh	ранний
der Frühling, -e	весна
der Frühstück, -e	завтрак
frühstücken	завтракать
für	для
der Fußball, -..e	футбол
der Fahrer,	водитель
der Fahrgast, -..e	пассажир
die Fahrkarte, -n	билет
der Fahrkartenautomat, -en	билетный автомат
der Fahrplan, -..e	расписание
die Fahrradmitnahme (Sing)	перевозка велоциседов
die Fahrschule, -n	автошкола
die Fahrt, -en	поездка
das Familienfest, -e	семейный праздник
fast	почти
das Fax, -e	факс
das Faxgerät, -e	факс (прибор)
der Februar	февраль
fehlen	недоставать
fehlend	недостающий
die Feier, -n	праздник
das Fenster,	окно
die Ferien (Sing)	каникулы
fern	дальний
das Fernsehen (Sing)	просмотр телевизора
das Fest, -e	праздник
die Festanstellung, -en	постоянное место
der Finger,	палец
der Fleischverkäufer,	продавец мяса
flexibel	гибкий
fliegen	лететь
der Flug, -..e	полет
die Flugdaten (Plural)	даты полета
das Flugzeug, -e	самолет
folgen	следовать
die Forelle, -n	форель
formell	формально
fragen	спрашивать
frei	свободный
fremd	чужой
die Fremdsprache, -n	иностранный язык
der Frisör, -e	парикмахер
früher	ранее
der Führerschein, -e	водительские права
funktionieren	функционировать
der Fuß, -..e	ступня
ganz	весь
gar keine	совсем никакие
gar nicht	совсем не
gar nichts	совсем ничего
die Garage, -n	гараж
der Garten	сад
geben	давать
geboren	рожденный
gebraucht	подержанный
der Geburtsort, -e	место рождения
der Geburtstag, -e	День рождения
die Geburtstagsparty, -s	вечеринка по случаю дня рождения
gefallen	нравиться
gehen	идти
das Geld (nur Sing.)	деньги
das Gemüse (nur Sing.)	овощ
der Gemüseladen,	овощной магазин
genau	именно
geöffnet	открытый
gern	охотно
der Geschäftsführer,	коммерческий директор
geschieden	разведенный
das Gespräch, -e	разговор
gestern	вчера
das Getränk, -e	напиток
das Gewicht, -e	вес
die Gitarre, -en	гитара
glauben	верить
gleich	сейчас
(der) Grad, -e	градус
das Gramm (nur Sing.)	грамм
die Grammatik, -en	грамматика
der Grill, -s	гриль
grillen	жарить на гриле
die Grillparty, -s	вечеринка с грилем
groß	большой
die Gruppe, -en	группа
der Gruß, -..e	привет
gucken	смотреть
gut	хороший
Gute Besserung!	Скорейшего выздоровления!
die Garantie, -n	гарантия
der Gärtner,	садовник
der Gast, -..e	гость
die Gebäudereinigung (Sing)	уборка помещения
die Gebrauchsanweisung, -en	руководтство по эксплуатации
das Geburtsdatum (Sing)	дата рождения
das Geburtsland, -..er	место рождения (страна рождения
das Gedicht, -e	стихотворение
gegen	против
die Geheimnummer, -n	секретный номер
gehören	принадлежать
das Geld (Sing)	денъги
das Gemüsegeschäft, -e	овощной магазин
generell	обобщенно
genug	достаточно
das Gepäck (Sing)	багаж
geradeaus	прямо
das Gerät, -e	прибор
das Geschäft, -e	магазин
das Geschlecht, -er	пол (мужско / женский)
geschlossen	закрыто
gesund	здоровый
die Gesundheit (Sing)	здоровье
das Gewitter,	гроза
gießen	лить
das Glas, -..er	стакан
das Gleis, -e	путь (ж/д)
das Glück (Sing)	удача
glücklich	счастливый
die Größe, -n	размер
der Grund, -..e	причина
die Gruppe, -n	группа
günstig	недорогой
der Gürtel,	ремень
haben	иметь
halb	половина
das Handy, -s	мобильный телефон
der Hase, -n	заяц
hässlich	некрасивый
der Hauptbahnhof, -..e	главный вокзал
der Hauptsatz, -..e	главное предложение
die Hauptstadt, -..e	столица
das Haus, -..er	дом
die Hausaufgabe, -n	домашнее задание
nach Hause	домой
die Hausnummer, -n	домашний телефон
das Heimatland, -..er	родина
heißen	называть
hell	яркий
helfen	помогать
der Herbst, -e	осень
der Herd, -e	плита
die Herkunft, -e	происхождение
heute	сегодня
hier	здесь
die Himmelsrichtung, -en	сторона света
das Hobby, -s	хобби
die Heizung, -en	отопление
der Hof, -..e	двор
hoffen	надеяться
hoffentlich	надеюсь
hören	слушать
die Höhe, -n	высота
der Hunger (nur Sing.)	голод
das Haar, -e	волос
der Hals, -..e	горло
die Halsschmerzen (Plural)	боли в горле
halten	останавливаться
die Haltestelle, -n	остановка
die Hand, -..e	кисть руки
die Handlungsanweisung, -en	руководтство к действию
die Hauptwohnung, -en	основная квартира
die Hausfrau, -en	домохозяйка
die Haushaltshilfe, -n	помощь по хозяству (домработница)
der Hausmeister,	домоуправитель
die Hausverwaltung, -en	домоуправление
das Heft, -e	тетрадь
die Heimat (Sing)	родина
heiraten	жениться
das Hemd,-en	рубашка
das Herkunftsland, -..er	страна происхождения
der Hersteller,	производитель
das Herz, -n	сердце
herhören	слушать
die Hilfe, -n	помощь
hinfahren	отвозить
hinfallen	падать
die Hochzeit, -en	свадьба
höflich	вежливый
holen	забирать
die Hose, -n	штаны
das Hotel, -s	отель
der Hund, -e	собака
die Idee, -n	идея
im Monat	в месяц
immer	всегда
die Immobilie, -n	недвижимость
in der Nacht	ночью
die Information, -en	информация
das Instrument, -e	инструмент
der Intensivkurs, -e	интенсивный курс
international	международный
italienisch	италъянский
die Immobilienverwaltung, -en	управление недвижимостью
die Informatik (Sing)	информатика
informell	неофициально
informieren	информировать
das Interesse (Sing)	интерес
das Internet (Sing)	интернет
das Jahr, -e	год
die Jahreszeit, -en	время года
japanisch	японский
jede	каждая
jetzt	сейчас
das/ der Joghurt, -s	йогурт
der Junge, -n	мальчик
die Jacke, -n	куртка
der Januar	январь
die Jeans (Plural)	джинсы
jemand	кто-то
jeweils	соответственно
der Job, -s	работа
joggen	делать пробежки (например
der Juli	июль
der Juni	июнь
der Kaffee, -s	кофе
kalt	холодный
die Kaltmiete, -n	квартплата без расходов по отоплению
das Karate (nur Sing.)	карате
das Kärtchen,	карточка
die Karte, -n	карта
die Kartoffel, -n	картофель
der Käse (nur Sing.)	сыр
das Käsebrot, -e	бутерброд с сыром
die Kasse, -n	касса
kaufen	купить
die Kaution, -en	залог
kennen	знать
das Kilo, -s	килограмм
das Kind, -er	ребенок
das Kino, -s	кино
die Klasse, -n	класс
der Kleiderschrank, -..e	платяной шкаф
die Kleinanzeige, -n	маленькое объявление
kochen	готовить
die Kohle (nur Sing.)	уголь
kommen	приходить
die Kommunikation (nur Sing.)	коммуникация
komplett	полный
die Konjugation, -en	спряжение
der Korb, -..e	коробка
korrigieren	исправлять
kosten	стоить
krank	больной
der Kriminalfilm, -e	детектив
kroatisch	хорватский
die Küche, -n	кухня
der Kühlschrank, -..e	холодильник
der Kuchen,	пирог
die Kultur, -en	культура
der Kunde, -n	клиент
die Kundin, -nen	клиентка
der Kurs, -e	курс
der Kursleiter,	руководитель курса
die Kursleiterin,	руководительница курса
kurz	короткий
der Kalender,	календарь
der Karneval (Sing)	карнавал
der Kasten, -..	ящик
die Katze, -n	кошка
die Kauffrau, -en	коммерсантка
das Kaufhaus, -..er	универмаг
der Kaufmann	коммерсант
der Keller,	подвал
der Kellner,	официант
kennen lernen	познакомиться
die Kenntnisse (Plural)	знание
der Kiosk, -s	киоск
klar	ясный
das Kleid, -er	платье
die Kleidung (Sing)	одежда
der Knochen,	кость
der Koch, -..e	повар
das Kochbuch, -..er	поварная книга
der Koffer,	чемодан
kompetent	компетентный
der Kopf, -..e	голова
der Körperteil, -e	часть тела
die Kosmetik, -a	косметика
das Krankenhaus, -..er	больница
der Krankenpfleger,	санитар
die Krankenschwester, -n	медсестра
die Krankenversicherung, -en	медицинская стреаховка
die Krankheit, -en	болезнь
die Krankmeldung, -en	справка о болезни
das Kreuz, -e	крест
der Kugelschreiber,	шариковая ручка
(sich) kümmern	заботитъся
der Kundendienst (Sing)	служба по работе с клиентами
das Kursbuch, -..er	учебник
der Laden, ..	магазин
die Lampe, -n	лампа
das Land, -..er	страна
die Landkarte, -n	географическая карта
langsam	медленный
leben	жить
lebend	живой
das Leder,	кожа (материал)
ledig	холостой/незамужняя
der Lehrer,	учитель
die Lehrerin, -nen	учительница
leider	к сожалению
die Lektion, -en	лекция
lernen	учить
lesen	читать
das Lieblingsbuch, -..er	любимая книга
der Lieblingsmusik, (nur Sing.)	любимая музыка
liegen	находитъся
die Liste, -n	список
der Liter,	литр
lachen	смеятъся
das Ladegerät, -e	прибор для подзарядки
laden	заряжать
der Lagerverkauf, -..e	продажа со склада
laufen	бегать
das Leben (Sing)	жизнь
die Lebensgeschichte, -n	история жизни
das Lebensjahr, -e	год жизни
das Lebensmittel,	продовольственные товары
legen	класть
leicht	легкий
die Leidenschaft, -en	страсть
leihen	одалживать
der Lesetext, -e	текст для чтения
die Leute (Plural)	люди
das Licht, -er	свет
lieben	любить
das Lied, -er	песня
liefern	доставлять
der LKW, -s	грузовая машина
lösen	решать
die Lösung, -en	решение
die Lust (Sing)	настроение
lustig	смешной
machen	делать
das Mädchen,	девочка
der Mai (nur Sing.)	май
(die) Mama, -s	мама
der Mann, -..er	мужчина
die Marke, -n	марка
markieren	отмечать
der März, -e	март
die Maschine, -n	машина
maskulin v	мужской род
die Maßeinheit, -en	единица меры
die Matratze, -en	матрац
mehr	еще
meist	в основном
die Mengenangabe, -n	данные о количестве
das Metall, -e	металл
der Meter, -e	метр
der Metzger,	мясник
die Miete, -n	квартплата
der Mietmarkt, -..e	рынок жилья
der Mietpreis, -e	стоимость съема
die Migration, -en	миграция
die Milch (nur Sing.)	молоко
die Million, en	миллион
das Mineralwasser,	минеральная вода
minimal	минимальмый
minus	минус
das Missfallen (nur Sing.)	недоволъство
mitbringen	приносить с собой
mitkommen	пойти вместе
mitmachen	учавствовать
mitnehmen	братъ с собой
der Mittag, -e	полдень
das Mittagessen,	полдник
(der) Mittwoch,	среда
das Möbel,	мебель
möbliert	меблированный
das Modalverb v	модальный глагол
der Monat, -e	месяц
die Monatsmiete, -n	месячная квартплата
(der) Montag, -e	понедельник
der Morgen (nur Sing.)	утро
morgens v	по утрам
müde	уставший
die Musik (nur Sing.)	музыка
die Mutter, -..	мама
manchmal	иногда
der Maler,	- маляр
der Mantel, -..	палъто
der Mechaniker,	механик
das Medikament, -e	медикамент
die Medizin (Sing)	медицина
das Meer, -e	море
die Meinung, -en	мнение
der Meister,	мастер
das Meldeformular, -e	формуляр заявления
melden	заявлять
der Mensch, -en	человек
die Minute, -n	минута
mischen	мешать
der Mist (Sing)	навоз
das Mistwetter (Sing)	ужасная погода
mitfahren	ехать вместе с кем-то
mitgehen	идти вместе с кем-то
das Mitglied, -er	член какого-то общества
mitsingen	петь вместе с кем-то
die Mittagspause, -n	обеденный перерыв
die Mitteilung, -en	сообщение
das Modell, -e	модель
das Modem, -s	модем
modern	современный
möglich	возможный
der Moment, -e	момент
der Mund, -..er	рот
mündlich	устный
das Museum, Museen	музей
der Musiker,	музыкант
nachfragen	справляться
der Nachmittag, -e	послеобеденное время
die Nachrichten (nur Plural)	сообщения
nachsprechen	повторить
die Nacht, -e	ночь
der Name, -n	имя
nämlich	а именно
die Negation, -en	отрицание
der Negativartikel,	негативартикль
neu	новый
neutral	средний род
noch	еще
das Nomen,	существительное
der Nominativ, -e v	именительный падеж
der Norden (Sing.)	север
der Nudelsalat, -e	салат из вермишели / лапши
null	нуль
die Nummer, -n	номер
die Nachbarin, -nen	сосед
nachmachen	подражать
nachsehen	посмотреть
die Nachsilbe, -n	суффикс
die Nähe (Sing)	близость
nämlich а	именно
die Nase, -n	нос
die Nationalität, -en	национальность
nehmen	брать
nennen	называть
nett	приятный
nie	никогда
der Notdienst (Sing)	аварийная служба
die Note, -n	оценка
notieren	отмечать
die Notiz, -en	запись
der November	ноябрь
das Obst (Sing)	фрукты
oder	или
offiziell	официальный
die Orange	апельсин
ordnen	располагать
der Ort, -e	место
der Osten (Sing)	восток
der Ober,	официант
das Obergeschoss, -e	верхний этаж
offen	- открытый
öffentlich	общественный
öffnen	открывать
oft	часто
ohne	без
das Ohr, -en	ухо
der Oktober	октябрь
die Oma, -s	бабушка
die Ordinalzahl, -en	порядковое числительное
die Orientierung (Sing)	ориентация
das Osterei, -er	пасхальное яйцо
der Osterhase, -n	пасхальный заяц
(das) Ostern (Sing)	Пасха
die Packung, -en	упаковка
der Papa, -s	папа
der Park, -s	парк
der Partner,	партнер
die Partnerin, -nen	партнерша
die Party, -s	вечеринка
passen	подходить
das Perfekt (Sing.)	перфект
die Person, -en	особа
das Personalpronomen,	личное местоимение
der Pfeil, -e	стрела
das Pfund, -e	фунт
die Phonetik (Sing.)	фонетика
plus	плюс
die Position, -en	позиция
die Postleitzahl, -en	почтовый индекс
der Preis, -e	цена
prima	что надо!
privat	частный
das Problem, -e	проблема
das Produkt, -e	продукт
die Prognose, -n	прогноз
das Projekt, -e	проэкт
der Prospekt, -e	проспект
die Prüfung, en	экзамен
das Paket, -e	пакет
das Papier, -e	бумага
parken	парковаться
der Parkplatz, -..e	парковка
der Pass,	паспорт
passieren	происходить
der Patient, -en	пациент
die Pauschalpreisreparatur, -en	общая цена ремонта
die Pause, -n	пауза
das Personalmanagement (Sing)	управление персоналом
(das) Pfingsten	Троица
die Pflanze, -n	растение
der Pflegedienst, -e	обслуживание
der Pfleger,	санитар
der PKW, -s	легковой автомобиль
der Plan, -..e	план
der Platz, -..e	место
der Polizist, -en	полицейский
die Post (Sing)	почта
praktisch	практичный
preiswert	выгодный по цене
das Programm, -e	программа
der Programmierer,	программист
prüfen	сдавать экзамен
der Prüfer,	экзаменатор
die Prüferin, -nen	экзаменаторша
der Pullover,	полувер
der Pulli, -s	легкий свитер
der Punkt, -e	точка
pünktlich	пунктуальный
die Putzhilfe, -n	помощь в уборке
das Quiz (Sing.)	викторина
das Rad, -..er	колесо
das Rätsel,	- загадка
der Regen (Sing)	дождь
regnen, es regnet	идет дождь
der Reis (Sing.)	рис
die Reise, -n	путешествие
richtig	правильный
das Rollenspiel, -e	ролевая игра
rund	круглый
das Radio, -s	радио
die Radtour, -en	тур на велосипеде
die Rakete, -n	ракета
der Rat	совет
der Ratschlag, -..e	совет
rauchen	курить
die Rechnung, -en	счет
das Regal, -e	полка
der Regenschirm, -e	зонт от дождя
der Regionalexpress (Sing)	региональный экспресс
rein	совсем
die Reinigungskraft, -..e	способность к самоочищению
das Reisebüro, -s	туристическое бюро
reisen	путешествовать
der Rekord, -e	рекорд
die Reparatur, -en	ремонт
reparieren	ремонтировать
reservierungspflichtig	обязательное резервирование
das Restaurant, -s	ресторан
restlich	остальной
das Rezept, -e	рецепт
der Rock, -..e	юбка
der Rücken,	-спина
rückwärts	назад
rufen	звонить
ruhig	тихий
die Rundschau (Sing)	обозрение
der Saft, -..e	сок
sagen	сказать
die Sahne (Sing.)	сливки
der Salat, -e	салат
das Salz, -e	соль
sammeln	собирать
(der) Samstag, -e	суббота
der Satz, -..e	предложение
die Satzmelodie, -n	интонация предложения
das Satzzeichen,	знак препинания
schade	жаль
schauen	смотреть
scheinen	сиять
das Schild, -e	вывеска
schlafen	спать
schlecht	плохой
schmal	узкий
schmecken	пробовать
schneien, es schneit	идет снег
die Schokolade, -n	шоколад
die Schokomilch (Sing.)	шоколадное молоко
schon	уже
schön	красивый
schon lange	уже давно
der Schrank, -..e	шкаф
schreiben	писать
der Schreibtisch, -e	письменный стол
die Schule, -n	школа
der Schultag, -e	школьный день
die Schultüte,-en	школьный кулек
die Schwester, -n	сестра
das Schwimmbad, -..er	бассейн
der See, -n	озеро
sehen	видеть
sehr	очень
die Seite, -n	сторона
das Sekretariat, -e	секретариат
selbst	сам
der Sessel,	кресло
sicher	уверенный
singen	петь
der Singular (nur Sing.)	единственное число
sinken	падать
das Sofa, -s	софа
der Sohn, -..e	сын
der Sommer,	лето
solche	такие
das Sonderangebot, -e	спецпредложение
die Sonne, -n	солнце
der Sonnenschein (Sing.)	солнечный свет
sonnig	солнечный
(der) Sonntag, -e	воскресение
sonst	еще
spät	поздно
spazieren gehen	идти прогулятъся
das Spiel, -e	игра
spielen	играть
die Sprache, -n	язык
die Sprachschule, -n	языковая школа
sprechen	говорить
die Sprechstunde, -n	приемное время
die Stadt, -..e	город
stark	сильный
steigen	подниматъся
stimmen	быть верным (корректным)
der Stock, -..e	этаж
die Straße, -n	улица
die Strategie, -n	стратегия
das Stück, -e	штука
der Stuhl, -..e	стул
die Stunde, -n	час
suchen	искать
der Süden (Sing.)	юг
das Supermarkt, -..e	супермаркет
die Sache, -n	вещь
die Salbe, -n	мазь
sauber	чистый
die S-Bahn, -en	трамвай
der Schalter,	окно
die Schatzsuche (Sing)	поиск сокровищ
schicken	посылать
schließen	закрывать
schlimm	плохой
der Schluss, -..e	конец
der Schlüssel,	ключ
die Schmerzen (Plural)	боли
schmutzig	грязный
der Schneider,	портной
schnell	быстрый
der Schnellbahnplan, -..e	план метро
die Schreibwaren (Plural)	канцелярские принадлежности
der Schritte, -e	шаг
der Schuh, -e	ботинок
der Schüler,	ученик
die Schülerin, nen	ученица
der Schweißer,	сварщик
schwer	тяжело
schwierig	тяжелый
der Sekretär, -e	секретарь
die Sekretärin, -nen	секретарша
der Sekt (Sing)	шампанское / игристое вино
die Sekunde, -n	секунда
selbstständig	самостоятельный
separat	отдельный
der September	сентябрь
der Service (Sing)	сервис
die Serviceleistung, -en	сервисная услуга
die Sicherheit, -en	безопасность
(das) Silvester (Sing)	Ночь перед Рождеством
die Situation, en	ситуация
sitzen	сидеть
der Ski, er	лыжи
sofort	сейчас
der Sommerschlussverkauf (Sing)	летняя распродажа
die Sonderaktion, -en	специальная акция
sorgen	заботиться
der Sparpreis, -e	экономичная цена
der Spaß, -..e	удовольствие
der Spaziergang, -..e	прогулка
die Speisekarte, -n	меню в ресторане или кафе
die Sprechzeit, -en	часы приема
die Staatsangehörigkeit (Sing)	гражданство
die Stadtbibliothek, -en	городская библиотека
der Stadtplan, -..e	план города
der Stadtteil, -e	чать города
der Start, -s	старт
die Station, -en	станция
stattfinden	состояться
die Steckdose, -n	розетка
stecken	втыкать
der Stecker,	штепсель
stehen	стоять
die Stelle, -n	место
stellen	ставить
die Stellenanzeige, -n	реклама
das Stellengesuch, -e	поиск места работы
das Stichwortverzeichnis, -se	предметный указатель
der Stift, -e	штифт
der Stifthalter,	владелец карандаша
die Straßenbahn, -en	трамвай
streichen	подчеркивать
streiken	бастовать
der Stress (Sing)	стресс
die Strophe, -n	строфа
der Student, -en	студент
sympathisch	симпатичный
die Tabelle, n	таблица
die Tafel, -n	доска
der Tag, -e	день
der Tagesablauf, -..e	протекание дня
die Tageszeit, -en	время суток
tanzen gehen	идти танцевать
der Tanzkurs, -e	курс танцев
die Tasse, -n	чашка
der Tee, -s	чай
teilnehmen	принимать участие
das Telefongespräch, -e	телефонный разговор
die Temperatur, -en	температура
temporal	временный
teuer	дорогой
der Тext, -e	текст
die Tiefe, -n	глубина
der Tisch, -e	стол
die Tochter, -..e	дочь
die Toilette, -n	туалет
die Tomate, -n	помидор
total	полный
treffen	встречать
trennbar	отделимый
trinken	пить
das TV, -s	телевидение
die Tablette, -n	таблетка
täglich	ежедневный
die Tasche, -n	сумка
das Taxi, -s	такси
das Team, -s	команда
der Techniker,	техник
der Teil, -e	часть
der Teilnehmer,	участник
die Telefonansage, -n	телефонное объявление
der Termin, -e	назначенный срок
das Terminal, -s	терминал
die Terminvereinbarung, -en	Деловое свидание
die Terrasse, -n	терасса
der Test, -s	тест
das Theater,	театр
das Thema, die Themen	тема
das Ticket, -s	билет
der tipp, -s	совет
tragen	носить (одежду)
der Trainer,	тренер
trainieren	тренироваться
das Training (Sing)	тренинг
die Treppe, -n	лестница
trotzdem	все таки
das T-Shirt, -s	майка
tun	делать
die Tür, -en	дверь
über	о
überall	везде
die Uhr, -en	часы
die Umschlagseite, -n	страница обложки
unbekannt	неизвестный
unbestimmt	неопределенный
und	и
ungefähr	около
unter	под
der Unterricht, -e	занятие
unterstreichen	подчеркивать
der Urlaub, -e	отпуск
die U-Bahn, -en	метро
der U-Bahnhof, -..e	станция метро
üben	над
überlegen	обдумывать
übermorgen	послезавтра
die Übersichtsseite, -n	сторона обзора
übertragen	передавать
üblich	(обще)принятый
die Übung, -en	учение
umsteigen	пересаживаться
umziehen	переезжать
unbedingt	обязательно
der Unfall, -..e	авария
unfreundlich	недружелюбный
die Universität, -e	университет
das Untergeschoss, -e	подвальный этаж
die Unterlagen (Sing)	документы
der Unterschied, -e	разница
unterschreiben	подписывать
die Unterschrift, -en	подпись
unterwegs	в дороге
unwichtig	неважный
der Urlaub (Sing)	отпуск
die USA (Plural)	США
die Variante, -en	вариант
variieren	варъировать
der Vater,	отец
die Verabredung, -en	встреча
das Verb, -en	глагол
verbinden	связывать
der Verein, -e	общество
vergessen	забывать
die Verhandlungsbasis, -basen	основа для переговоров (например
verheiratet	состоять в браке
verkaufen	продавать
der Verkäufer,	продавец
die Verkäuferin, -nen	продавщица
verstehen	понимать
verwitwet	быть вдовцом / вдовой
das Viertel,	четверть
die Vorliebe, -n	влюбленность
der Vormittag, -e	дообеденное время
der Vorname, -n	имя
der Vorschlag, -..e	предложение
die Vorsicht (Sing.)	осторожность
vorstellen	представлять
die Variation, -en	вариант
verabschieden	провожать
der Verband, -..e	повязка
verbunden	ошибаться
der Verdienst (Sing)	заработок
vereinbaren	договариваться
verlegen	переносить
verletzen	поранить
verlieren	потерять
die Versichertenkarte, -n	страховая карточка
die Versicherung, -en	страховка
die Verspätung, -en	опоздание
das Verständnis (Sing)	понимание
verstecken	прятать
das Video, -s	видео
viel	много
die Viertelstunde, -n	четверть часа
voraussichtlich	предполагаемый
vorbeikommen	зайти
der Vorstand, -..e	правление
die Vorstellung, -en	представление
die Wandzeitung, -en	стенгазета
wann	когда
warm	теплый
die Warmmiete, -n	квартплата за все
warum	почему
was	что
das Waschbecken,	раковина
waschen	мыть
die Waschmaschine, -n	стиральная машина
das Wasser (Sing.)	вода
der Wein, -e	вино
die Weinflasche, -n	бутылка вина
weiter	дальше
welche	какой
die Wendung, -en	поворот/оборот
wer	кто
der Wert, -e	ценность
der Westen (Sing.)	запад
wichtig	важный
wie	как
wieder	скоро
das Wiederhören (Sing)	сокращ. от Досвидания (при телефонных разговорах)
das Wiedersehen (Sing.)	сокращ. от Досвидания
der Wind, -e	ветер
windig	ветренный
der Winter,	зима
wirklich	действительно
wissen	знать
wo	где
die Woche, -n	неделя
das Wochenende, -n	выходные дни
woher	откуда
wohnen	жить
der Wohnort, -e	место жительства
der Wohnraum, -..e	жилплощадь
die Wohnung, -en	квартира
die Wohnungsanzeige, -n	объявление о жил.площади
das Wohnzimmer,	жилая комната
wollen	хотеть
das Wort, -e	слово
die Worbildung, -en	словообразование
das Wörterbuch, -..er	словарь
der Wunsch, -..e	желание
die Wurst,-..e	колбаса
das Wurstbrot, -e	бутерброд с колбасой
der Wagen,	автомобиль
wählen	выбирать
während	во время
warten	ждать
das Weihnachten (Sing)	Рождество
der Weihnachtsbaum, -..e	Рождественское дерево
der Weihnachtsmann, -..er	Санта Клаус
die Weintraube, -n	виноград
weit	широкий
weitergehen	идти дальше
der Weltrekord, -e	мировой рекорд
wenig	мало
werden	становиться
die Werkstatt, -..en	мастерская
werktags	по рабочим дням
wiederholen	повторять
die Wiese, -n	луг
der Wochentag, -e	день недели
wöchentlich	еженедельно
der Wohnanlage, -n	жилое строение
wünschen	желать
die Zahl, -en	число
zeichnen	черить
zeigen	показывать
die Zeit, -en	время
die Zeitung, -en	газета
der Zentimeter,	сантиметр
der Zettel,	записка
das Zimmer,	комната
der Zucker (Sing.)	сахар
zuerst	сначала
zuordnen	подбирать
zusammen	вместе
zusammensetzen	составлять
der Zustand, -..e	состояние
die Zustimmung, -en	согласие
zwischen	между
zahlen	считать
der Zahn, -..e	зуб
die Zeichnung, -en	рисунок
ziehen	тянуть
die Zigarette, -n	сигарета
die Zollkontrolle, -n	таможенный контроль
zufrieden	довольный
der Zug, -..e	поезд
zumachen	закрывать
zurück	обратно
zurückkommen	возвращаться
die Zusage, -n	согласие
zuverlässig	надежный
zweit, zu zweit	во-вторых