giggle	хихикать
coil	катушка
oracle	прорицание
misconception	неправильное понимание
rimy	заиндевевший
housing	корпус
endian	обратный порядок байт
jig	зажимное приспособление
presently	вскоре
veldt	плато
nursery	десткая
well	колодец
knob	выпуклость
ajar	приоткрытый
tillage	пашня
vapour	пар
procedural	процедурный
perspiration	потение
dismayed	встревоженный
clenched	крепко сжатый
accusing	обвинительный
ulcer	язва
steamer	пароход
faintly	слабо
babbling	болтовня
innermost	глубочайший
imperceptible	незаметный
sulky	надутый
toot	гудок
tangle	путаница
pronoun	местоимение
pronounce	произносить
pronounciation	произношение
surpass	превосходить
figurine	статуэтка
errata	опечатка
drastic	решительный
infamous	позорный
sheer	абсолютный
grandeur	величие
splendour	блеск
crucial	ключевой
pygmy	пигмей
entiching	заманчивый
speck	пятно
tenth	составляющий одну десятую
receptive	чувствительный
overlap	перекрытие
serrated	зазубренный
topple	опрокидывать
niche	ниша
perilous	опасный
ferocious	дикий
desolate	заброшенный
pester	докучать
whittle	строгать
intrinsic	подлинный
kelp	ламинария
ambush	засада
slacken	ослаблять
straightforward	прямой
boldness	смелость
drawback	недостаток
auxiliary	вспомогательный
spur	шпора
ditch	ров
empower	уполномочивать
hiatus	пробел
chipped	с зазубринами
drool	нести чепуху
woe	горе
rendition	исполнение
blast	взрыв
poller	избиратель
as well as	а также
sleek	гладкий
subtle	тонкий
propel	приводить в движение
prerequisite	предпосылка
mundane	мирской
stutter	заикаться
standstill	остановка
halved	поделенный пополам
choppy	порывистый
impede	препятствовать
stipulate	оговаривать
robust	крепкий
manner	способ
denote	обозначать
finite	конечный
owing	обязанный
aquifer	водоносный слой
igneois	изверженный
shale	сланец
standpoint	точка зрения
colloquial	разговорный
canopy	навес
moraine	морена
damn	проклинать
snug	уютно
tallow	жир
tamp	набивать
fringe	бахрома
clink	звон
igniter	воспламенитель
tumbling	акробатика
glint	блеск
uncapped	раскрытый
shriek	визг
bare	голый
mouthpiece	мундштук
echoing	гулкий
stratum	слой
throb	биение
serum	сыворотка
squint	косоглазие
reside	проживать
sue	предъявлять иск
handwriting	почерк
hype	обман
dimly	тускло
bribe	взятка
look away	отвлекаться
ingot	болванка
allegiance	верность
disloyalty	неверность
litigation	судебные разбирательства
testimony	свидетельство
parity	соотношение
superiority	превосходство
nobility	знать
undreamed	невообразимый
odor	запах
headlong	опрометью
seep	просачиваться
intruder	нарушитель
replеnish	пополнять
revere	благоговеть
peregrine	сапсан
cog	зубец
perch	окунь
soar	парить
odds	шансы
prowl	рыскать
thriving	процветающий
staggering	ошеломляющий
glamour	очарование
bower	осенять
akin	похожий
favour	благоприятствовать
brazen	наглый
outskirt	окраина
posture	поза
vilify	поносить
preen	прихорашиваться
proliferation	распространение
credential	мандат
redundancy	избыточность
cynicism	цинизм
earnestly	серьезно
wad	пыж
tuck	складка
distill	дистиллировать
spout	носик
pop up	выскакивать
drench	пропитывать
dopy	наркотический
heck	щеколда
thinning	разведение
conjure	заклинать
aggravating	ухудшающий
kennel	конура
capillary	капилляр
toss	бросать
incinerator	мусоросжигательная печь
blotch	пятнистость
whoop	возглас
rasping	дребезжащий
sizzle	шипение
hatchling	детеныш
creeper	рептилия
ingenuity	изобретательность
sobering	отрезвление
cougar	пума
craftsmanship	мастерство
fetch	получать
populate	заселять
beneficial	благотворный
spank	шлепок
sneak	ябеда
shin	голень
flutter	трепетание
mourn	оплакивать
soot	сажа
bluish	голубоватый
smear	мазок
fiery	пламенный
cinder	окалина
asylum	убежище
outlawed	вне закона
bloodshed	кровопролитие
rot	гниль
whore	шлюха
wedlock	супружество
sailcloth	парусина
plight	положение
imprinted	отпечатанный
chastise	карать
feign	симулировать
feigned	притворный
cruelty	жестокость
uncommon	редкий
ado	суета
winder	мотальная машина
claret	бордо
insatiable	ненасытный
consignment	груз
purveyor	поставщик
petticoat	нижняя юбка
turd	дерьмо
illuminati	эрудиты
sheath	оболочка
odious	ненавистный
slicker	дождевик
musty	затхлый
shuddering	дрожащий
whimper	хныканье
mindlessness	безолаберность
hurl	метать
shovelful	полная лопата чего-либо
prep	приготовительный
nope	неа
fallback	резерв
by the way	кстати
deviate	отклоняться
twitch	подергивание
condemnation	осуждение
ravenous	хищный
trench	траншея
slump	кризис
hallmark	отличительный признак
manacle	наручники
billable	оплачеваемый
contest	конкурс
scoff	издеваться
pierce	проколоть
exhale	выдыхать
facet	грань
hurdle	препятствие
wipe out	уничтожать
fraudulent	мошеннический
feasible	выполнимый
bidding	торги
thud	глухой стук
holistic	целостный
pail	ведерко
smoulder	тлеть
yammering	ноющий
ruddy	румяный
digest	справочник
yank	рывок
nomadic	кочевой
breach	нарушение
inferior	низший
serenity	спокойствие
pagan	язычник
quibble	каламбур
coincidence	совпадение
dyke	дамба
gullet	пищевод
snippet	отрывок
inn	гостиница
recreation	развлечение
hatred	ненависть
lodge	домик
staple	шпатель
wildcard	подстановочный
sagged	прогибаться
nudge	слегка подталкивать локтем
squatted	приседать
shoo	кыш
deprecate	протестовать
numb	онемевший
showcase	витрина
bosh	вздор
jolt	толчок
toil	усиленно трудиться
gibber	быстрая невнятная речь
retaliation	возмездие
dammit	черт побери!
strew	посыпать
profusion	расточительность
mediocre	посредственный
arsonist	поджигатель
batter	жидкое тесто
nimble	проворный
dapper	щегольски одетый
strut	распорка
delinquent	преступник
contemptible	презренный
tamed	прирученный
homely	уютный
pesky	надоедливый
girdle	пояс
furl	свертывать
drear	тоскливый
gotchas	подводные камни
verbiage	пустословие
tumultious	бурный
indispensability	необходимость
stepwise	ступенчато
shingle	кровельная дранка
creak	скрип
certitude	уверенность
stun	оглушать
encompass	охватывать
outstanding	выдающийся
filigree	филигрань
scolding	нагоняй
haggle	тогроваться
nag	пилить
invigorate	подбадривать
prior	предшествующий
demise	гибель
hindrance	помеха
detest	ненавидеть
latrine	уборная
adhere	придерживаться
drunkard	пьяница
parry	парировать
chuckle	хихикать
scripture	священное писание
threadbare	потертый
folly	глупость
flailing	верчение
traitor	предатель
welter	сумбур
limply	безвольно
disseminate	распространять
memorandum	деловая записка
tacit	молчаливый
fiscal	финансовый
framework	рамки
conduit	трубопровод
incentives	стимулы
chant	петь
perfunctory	небрежный
chaff	мякина
cripple	калека
inconspicuous	незаметный
burly	дородный
resentful	обидчивый
revulsion	отвращение
flinch	вздрогнуть
blankly	тупо
duct	канал
cringe	съеживаться
onset	начало
whim	прихоть
caveat	предостережение
capitalize	капитализировать
mite	клещ
meticulous	дотошный
tousled	взлохмаченный
gist	суть
meekly	кротко
natter	болтовня
circadian	циркадный
cubicle	кабинка
tactful	тактичный
hassle	стычка
drowsiness	сонливость
rumble	грохот
mesmerize	гипнотизировать
repetitive	повторяющийся
sturdy	крепкий
inherently	по существу
propensity	наклонности
bustle	суета
astoundingly	удивительно
flimsy	непрочный
shatter	раздробить
menacing	угрожающий
idly	праздно
all in all	в общем
fluff	пух
squishy	болотистый
mindset	склад ума
musing	размышление
propulsion	силовая установка
proximity	близость
churn	сбивать
pinpoint	точный
queasy	привередливый
juggle	жонглировать
valise	саквояж
whatsoever	что бы ни
venom	яд
tricky	запутанный
outbreak	вспышка
dazzle	ослеплять
moron	придурок
flummox	смущать
fleeting	скоротечный
scrawl	каракули
blurt	выпалить
ocher	охра
butterscotch	ириски
outrage	безобразие
raving	бесноватый
belch	отрыжка
fumbling	неловкий
sliver	щепка
dent	вмятина
blastula	зародышевый пузырь
discrepancy	несоответствие
innately	врожденно
swath	прокос
smugly	самодовольно
engrossed	поглощенный
woolgathering	рассеянность
stomp	топать
kink	чудить
searing	жгучая
catharsis	катарсис
malleable	податливый
hallows	святые мощи
hallow	святой
foster	способствовать
glyph	глиф
alleviate	смягчать
subset	подмножество
rogue	изгой
resilience	упругость
infringe	посягать
pittance	жалкие гроши
peddle	торговать вразнос
clad	одевать
bole	ствол
penance	покаяние
bum	задница
wayward	своенравный
frisky	резвый
internilize	усваивать
hone	затачивать
refine	усовершенствовать
infest	кишеть
ongoing	постоянный
gobble	пожирать
fungible	заменяемый
infidelity	неверность
horde	орда
haul	тащить
acolyte	псаломщик
upheaval	переворот
crank	кривошип
emanating	исходящий
endearing	милый
blacktop	асфальтовое покрытие
gratingly	грохоча
providentially	чудесно
bedlam	кавардак
heartstrings	глубочайшие чувства
longing	стремление
palpitations	сильное сердцебиение
brat	отродье
fixture	приспособление
deplore	оплакивать
pundit	ученый муж
sob	рыдать
scalding	обжигающий
fugitive	беглец
pandemonium	столпотворение
plummeting	резкое падение
falter	спотыкаться
scuttle	люк
boyhood	отрочество
slanting	косой
wart	бородавка
callus	мозоль
peg	колышек
delectable	восхитительный
fudge	помадка
guzzle	пропивать
oblivion	забвение
dilate	распространяться
make sense	иметь смысл
rocker	коромысло
dotty	рехнувшийся
daffy	свихнувшийся
goofy	тупой
loony	псих
up to now	до сих пор
cackle	кудахтать
dwindle	истощаться
douse	окунать
swerve	сворачивать
spellbound	завороженный
rubbery	эластичный
pungent	пикантный
stench	зловоние
tiddly	махонький
soothing	успокаивающий
chute	скат
precipice	пропасть
braid	оплетка
retch	позыв на рвоту
gummed	клейким
bramble	ежевика
squeak	писк
midget	карлик
denim	джинсы
gingerly	осторожно
collapsible	разборный
conseit	тщеславие
slum	трущобы
convolution	свертка
mural	фреска
sanity	вменяемость
pyre	погребальный костер
edifice	здание
heckle	чесалка для льна
affinity	сродство
holster	кобура
rascal	мошенник
saccharine	сахарин
vacuous	праздный
worship	поклоняться
dummy	фиктивный
gruffer	грубый
vehemently	неистово
ranget	колебался
bloodstained	окровавленный
soiled	грязный
wince	вздрогнуть
torment	мучить
ogle	строить глазки
gurney	медицинская каталка
scowl	хмуриться
patronizing	высокомерный
stamina	выносливость
porpoise	подпрыгивать
snapped	огрызнулся
derision	высмеивание
appall	потрясать
pleas	просьба
postpone	откладывать
chagrin	огорчение
bystander	свидетель
hornet	шершень
sham	притворство
stash	копить
unrivaled	непревзойденный
boilerplate	шаблонный
savant	ученый
bevel	скос
emboss	выбивать
swell	зыбь
ghastly	ужасный
smelly	вонючий
devise	разрабатывать
devide	перешеек
swapping	менять
circumvent	обойти
ingrained	укоренившийся
show up	появляться
eerily	устрашающе
fetuse	плод
hefty	здоровенный
transcendence	преводходство
kindle	зажигать
spatial	пространственный
debunk	развенчать
anticipatory	досрочный
plausibitity	правдоподобие
subsistence	пропитание
shedding	пролитие
means	средство
locus	местоположение
jamb	наличник
dispel	развеять
petulance	нетерпеливость
unerringly	безошибочно
standoffish	сдержанный
terse	краткий
gulp	глоток
wryly	криво
befuddle	одурманивать
bully	хулиган
swig	большой глоток
pushover	пустяковое дело
makeshift	импровизированный
ominous	зловещий
barb	зубец
clammy	липкий
congestion	перегруженность
infirmary	лазарет
unfathomable	непостижимый
pout	надутые губы
swoon	обморок
veer	менять курс
pushy	напористый
smudge	пятно
outing	выход
flanked	в окружении
vile	подлый
glitch	сбой
uneven	неровный
austere	аскетический
halo	гало
murky	темный
etch	гравировать
slink	красться
undercover	тайный
archly	лукаво
allure	очарование
tantalising	мучающий
blare	рев
illicit	незаконный
overlook	игнорировать
actuator	привод
quirky	ушлый
paramount	первостепенный
nook	закоулок
cranny	трещина
ruggedized	износоустойчивый
meagre	скудный
affidavit	аффидевит
poise	уравновешенность
pervasive	распространяющийся
overreliance	чрезмерное увлечение
instill	внушать
stringent	строгий
nascent	рождающийся
telecommuting	дистанционная работа
kite	воздушный змей
infuriatingly	раздражающе
infuriating	приводящий в ярость
partake	принимать участие
trivialize	опошлять
daunt	запугивать
passably	сносно
slog	сильный удар
shortcut	сокращенный
indoctrinate	внушать
litany	литания
minutiae	мелочи
tooltip	подсказка
momentarily	на мгновение
relentlessly	беспрестанно
by rote	наизусть
expel	высылать
lousy	паршивый
outreach	пропаганда
ebb	отлив
trickle	струйка
morbid	патологический
rollout	посадочная дистанция
volatility	летучесть
uphold	поддерживать
divulge	разглашать
supplant	вытеснять
redress	возмещение
conundrum	головоломка
endorse	одобрять
perpetrator	нарушитель
venue	место встречи
ramification	ветвление
covertly	скрытно
recap	резюмировать
inline out	встроенный
inadvertently	ненароком
meltdown	расплавление
jeopardy	подсудность
outpace	опережать
augment	увеличивать
tamper	подделывать
languish	томиться
subtly	тонко
bluntly	прямо
agility	проворство
suavely	вкрадчиво
competencies	умения
nitpicking	придирки
nitpick	придираться
unscathed	невредимый
bleak	мрачный
ran into	столкнуться с
muddle	темнить
tainted	испорченный
fleecy	кудрявый
calisthenics	физподготовка
penchant	склонность
plague	чума
slither	скатываться
shamble	тащиться
shred	шинковать
edgy	раздражительный
stifle	душить
scruffy	неряшливый
prom	выпускной вечер
nonchalant	беспечный
raucous	хриплый
streak	полоса
livid	синевато-багровый
coy	застенчивый
crabby	раздражительный
unequivocally	однозначно
interrogation	опрос
mollify	смягчать
placate	успокаивать
belatedly	запоздало
ostentatious	показной
genesis	генезис
pernicious	пагубный
brainiac	умник
vicious	порочный
fitfully	урывками
guesswork	догадки
miff	размолвка
moot	спорный вопрос
aloof	отчужденный
sinuous	извилистый
furtively	украдкой
unrelentingly	неумолимо
whir	жужжание
excruciating	мучительный
ambivalent	двойственный
barrette	заколка
apropos	по поводу
bleakly	безрадостно
sorely	тяжко
condone	освобождать от ответственности
iridescent	ражудный
glisten	блестеть
scarce	дефицитный
feck	действенность
feckless	безответственный
contrite	кающийся
arcane	скрытый
flippantly	непочтительно
exhilarate	веселить
impish	шаловливый
replete	переполненный
acerbic	терпкий
irk	надоедать
elude	ускользать
lariat	лассо
penalize	наказывать
streamline	обтекаемый
cutting edge	передовой
menial	слуга
laggard	увалень
chug	пыхтение
sweatpants	спортивные штаны
tatter	лохмотья
exuberantly	избыточно
shackles	кандалы
chasm	бездна
groggy	непрочный
frailty	хрупкость
pucker	морщиться
discernible	различимый
billow	вал
overbearing	властный
poignantly	едко
craggy	скалистый
loathe	ненавидеть
ornately	витиевато
wraith	призрак
avail	польза
loath	нежелающий
recommit	вновь
prodigal	мот
interim	промужуточный
lurch	крен
kiddo	малышка
reverie	мечтательность
disparaging	пренебрежительный
reciprocation	взаимный обмен
relent	смягчаться
unyielding	упорный
unruly	непослушный
muss	беспорядок
peal	трезвон
stance	позиция
windup	конец
inning	подача
infallible	непогрешимый
factly	разумющееся
split second	доли секунды
razz	малина
unperturbed	невозмутимый
bunt	пихать
algae	водоросли
moping	хандрить
infield	в поле
gait	походка
eyeful	прелестная женщина
brawn	мускульная сила
feline	кошачий
coax	уговаривать
unshakeable	непоколебимый
sachet	пакетик
astringency	терпкость
no way	ни за что
guttural	горловой
uptick	всплеск
sulk	дуться
backfire	обратный эффект
leper	прокаженный
duffel	спортивный костюм
derail	пускать под откос
shortstop	приятели
bloodcurdling	ужасающий
luscious	приторный
baleful	гибельный
coven	сборище
deftly	проворно
hem	подшивать
tint	оттенок
haphazard	бессистемный
graft	трансплантант
strenuous	напряженный
plummet	отвес
blur	пятно
quaver	дрожать
jut	выступ
glut	перенасыщение
fidget	ерзать
goo	что-либо липкое
looming	надвигающийся
reprieve	передышка
weasel	ласка
legible	разборчивый
askance	косо
whiteboard	доска
sanctuary	святилище
thrum	бахрома
giddy	головокружительный
genteel	благовоспитанный
ploy	уловка
bravado	бравада
indisputably	неоспоримо
contortion	выворачивание
stab	удар ножом
writhe	терзаться
impasse	тупик
shush	зашикать
gauze	марля
bleakness	оголенность
heatsink	радиатор
morass	трясина
taut	тугой
recliner	шезлонг
phony	фальшивый
selfhood	индивидуальность
readout	зачитать
pertussis	коклюш
vicarious	замещающий
brusquely	бесцеремонно
grumpily	сварливо
festoon	гирлянда
dumpster	мусорный контейнер
adversity	напасти
radiance	светимость
scathe	губить
spurt	рывок
sophomore	второкурсник
trite	банальный
heist	огрбление
thingy	штуковина
adornment	украшение
retrofit	модифицировать
alumni	выпускник
pertinent	уместный
imbibe	впитывать
frugal	скудный
lush	пышный
outage	перебой в работе
smelter	плавильная печь
laud	превозносить
flick	фильм
stockout	дефицит
unobtrusive	ненавязчивый
flaunt	выставлять напоказ
disparate	несоизмеримый
needless	излишний
interplay	взаимодействие
snappy	быстро
utility	полезность
repercussion	отзвук
compliance	соблюдение
incur	подвергаться
jugged	зубчатый
crock	черепок
cohesive	связующий
scrutinize	тщательно исследовать
despicable	презренный
lucrative	прибыльный
innocuous	безобидный
nefarious	гнусный
defraud	обманывать
outback	малонаселенный
leery	подозрительный
strangelet	страпелька
novel	роман
storefront	витрина
cater	угождать
milestone	веха
intertwine	закручиваться
from scratch	с нуля
worthwhile	стоящий
devious	окольный
inflate	раздувать
so as to	так чтобы
boon	благо
counterfeit	подделка
impediment	препятствие
cumbersome	громоздский
pertain	относиться
brainchild	замысел
proponent	стронник
perk	привилегия
payee	получатель платежа
hitmen	киллер
pitfall	западня
outmode	устаревать
stray	бездомный
in return	взамен
mere	простой
smack that	чмокнуть
specifically	конкретно
abreast	в ряд
embody	олицетворять
escapade	авантюра
pledge	залог
misnomer	неправильное название
synopsis	конспект
rasp	скрежет
afflict	тревожить
aperture	апертура
whopping	огромный
pest	вредитель
craze	мания
credible	заслуживающий доверия
outfox	перехитрить
ark	ковчег
slime	тина
viral	вирусный
outbound	исходящий
blunder	просчет
albeit	хотя
jot	йота
batty	тронутый
thus far	до сих пор
defamation	диффамация
longevity	долговечность
outlandish	диковинный
relinquish	отказываться
tuple	кортеж
chrysalis	куколка
lest	чтобы не
lurk	таиться
telltale	предательский
binge	выпивка
obesity	ожирение
efficacy	эффективность
firsthand	из первых рук
disreputable	постыдный
glean	подбирать колосья
bummer	лентяй
ruminate	раздумывать
legume	боб
clutter	беспорядок
deprovisioning	вывод из эксплуатации
perish	погибать
faceting	огранка
dormant	бездействующий
dorm	общая спальня
stifler	виселица
obsidian	обсидиан
diurnal	суточный
dovetail	ласточкин хвост
iconic	портретный
deterioration	ухудшение
fasting	голодание
potent	сильнодействующий
renown	известность
scavenge	продувать
turmeric	кукрума
quirk	галтель
voluptuous	сладострастный
curvy	соблазнительная
curvaceous	с красивыми округлыми формами
eradicate	искоренять
dexterity	ловкость
transient	преходящий
lounge	гостиная
lineage	родословная
promenade	прогулка
veritable	настоящий
concise	краткий
prosthetic	протезный
rover	пират
zap	затирать
needlessly	ненужно
phlegm	мокрота
wheeze	хрип
conversely	наоборот
adversely	неблагоприятно
rambunctious	раздражительный
lattice	решетка
get around	обойти
allot	отчислять
lockup	тупик
preventable	предотвратимый
coddle	кутать
by far	безусловно
handicap	гандикап
attune	делать созвучным
lesion	поражение
detour	объезд
veracity	правдивость
precursor	предшественник
equivocally	двусмысленно
stalemate	тупик
conjugation	коньюгация
booger	козявка
brink	край
promulgate	провозглашать
mart	рынок
complement	дополнение
mutualism	мутуализм
badger	барсук
infer	делать вывод
taint	зараза
conventional	обычный
vault	свод
be in touch	быть на связи
census	перепись
gout	подагра
objective	цель
inference	вывод
prejudice	предубеждение
disarray	беспорядок
preferential	преимущественный
forensic	судебный